VISIT_AREA_NM,REVISIT_INTENTION,RCMDTN_INTENTION,X_COORD,Y_COORD,Total_value
(재)수원컨벤션센터,7,8,127.0595135,37.2858235,15
100년가 공화춘 마포점,3,3,126.9447368,37.54104827,6
101닭갈비,4,4,127.365089,37.76864873,8
1059-3 Coffee House,5,5,127.0218714,37.25470186,10
108하늘계단,14,19,126.9818899,37.54644598,33
10월 19일,4,5,127.0106617,37.48123943,9
128pan,10,10,127.004446,37.58330614,20
12체어,5,5,126.9920009,37.53394843,10
133번지국밥,5,5,127.2058776,37.23612559,10
143베이커리&커피카페,5,5,127.0164493,37.27963636,10
153은하캠프,4,6,127.5087896,37.84282543,10
153포인츠부대찌개 용인본점,4,4,127.2344314,37.24864206,8
16호원조할머니손칼국수,5,5,126.5709075,37.27052255,10
178-12카페,9,10,127.5371278,37.39559121,19
1914라운지&바,4,4,127.0414919,37.50288653,8
1925 서울역그릴,2,3,127.1044462,37.51379215,5
1953연남옥,2,2,126.9033572,37.55331307,4
1967우육면 본점,2,3,126.7721389,37.65579497,5
1992 남산돈까스,3,3,126.9795066,37.5560558,6
1인1잔,14,14,126.9379326,37.64097031,28
2001아울렛 중계점,5,5,127.0678936,37.64121848,10
2001아울렛 천호점,5,4,127.1260373,37.5410534,9
2022 서신면 한마음 어울림 마당 축제,5,5,126.492769,33.50707896,10
2022계룡세계군문화엑스포 제1주차장,5,5,127.2314183,36.3178296,10
23호할머니손칼국수,3,4,126.5734173,37.28609337,7
24게스트하우스 동대문마켓점,3,3,127.010182,37.57064411,6
24게스트하우스 잠실점,4,4,127.0893764,37.50332042,8
24시무인카페 만월경상계점,4,4,127.0513554,37.67343063,8
24시뼈다귀감자탕,10,10,127.0061435,37.53336289,20
257의정부부대찌개 위례점,3,3,127.1398129,37.46736454,6
260도 송도유원지점,5,5,126.6553168,37.41728084,10
26호까치할머니 본관,5,5,126.6058175,37.23921213,10
272카페,2,3,126.7306502,37.36818708,5
29CM SEONGSU,4,3,127.0526184,37.54524903,7
3.1독립선언광장,5,5,126.9847295,37.5723041,10
3.5CM왕소금구이 새절역점,5,5,126.9155205,37.59165433,10
30.0커피,3,3,126.6574235,37.42326789,6
30년전통의메밀전집,3,4,127.7273222,37.87731582,7
3355펍,4,4,126.8921198,37.50436456,8
33마켓,3,4,126.9736676,37.57899564,7
33호할머니칼국수,5,5,126.5704998,37.27203211,10
365대부도캠핑시티,6,6,126.6448612,37.20136115,12
365북스,2,3,127.2979262,37.1736836,5
37.5 안성공도점,3,3,127.1962264,37.01028172,6
37.5 안성점,10,10,127.2448294,37.00242051,20
37.5시그니처,3,3,127.0226579,37.52012516,6
37.5케이티엑스 광명역점,4,4,126.8826232,37.4190189,8
3게스트하우스,6,8,126.9849926,37.5584369,14
3노트커피,3,3,126.9298431,37.52005243,6
3일한우국밥,3,3,126.9040519,37.51992618,6
3킬로미터,3,3,126.9698053,37.54423066,6
47번가찻집,3,4,126.9844551,37.57453583,7
5TO7,4,4,127.0433219,37.54608263,8
5번지짬뽕,3,2,126.7859384,37.40680252,5
60계 과천점,4,3,126.9930607,37.42790694,7
60년전통 신촌황소곱창 인계직영점,5,5,127.0307638,37.26503664,10
638DENO탄탄면,7,8,127.0686076,37.54520929,15
63뷔페 파빌리온,11,12,126.9401711,37.51981485,23
63스퀘어,9,8,126.9402004,37.51989955,17
63아트홀,7,7,126.9404583,37.51990689,14
63전망대,7,8,126.9402547,37.51988517,15
79파운야드 송도트리플타워점,4,4,126.6607196,37.38252441,8
8810리스트레토바,5,5,126.9230036,37.55988137,10
88로타리집,5,5,127.048366,37.73760471,10
88오락실,4,4,126.68845,37.34670755,8
8요일키친,4,4,127.1587423,37.84514372,8
8커피,5,5,126.7515447,37.50645189,10
91커피,4,4,127.0146137,37.28020606,8
943킹스크로스,9,10,126.9208039,37.55297828,19
955카페,9,9,127.090232,36.55925614,18
9월호텔,3,3,127.4929592,37.49032886,6
AAA베이커리,4,4,127.0311618,37.77394832,8
ABC마트 GS홍대홍익로점,3,4,126.9215767,37.5541555,7
ABC마트 ST구리점,4,5,127.1424289,37.6019456,9
ABC마트 ST수원남문점,5,6,127.0163628,37.27607186,11
ABC마트 ST포천송우리점,2,3,127.1328564,37.80967092,5
AC호텔 바이 메리어트 서울강남,13,14,127.0354203,37.50123697,27
AK& 기흥,9,7,127.1167124,37.27451522,16
AK& 홍대,23,23,126.9264078,37.55780855,46
AK플라자 AKTown점,69,69,127.00069,37.26555243,138
AK플라자 광명점,12,12,126.8828338,37.41866321,24
AK플라자 금정점,8,8,126.9441887,37.37275778,16
AK플라자 분당점,5,5,127.1231812,37.38523554,10
AK플라자 평택점,9,9,127.0855295,36.99125611,18
AK플라자수원점 AK갤러리,11,11,127.0006584,37.26556324,22
AN게스트하우스,3,3,127.0220675,37.50488028,6
APAP전망대,5,5,126.9261803,37.42117332,10
AY커피 수원시청점,5,5,127.026024,37.26415836,10
Aat,4,4,126.684474,37.70849109,8
Apple 가로수길,15,14,127.0227294,37.52081982,29
Apple 명동,26,27,126.9828408,37.56468142,53
Apple 여의도,5,5,126.9259413,37.52490015,10
Apt서울,5,5,126.9947097,37.53185105,10
BBQ 곤지암점,2,2,127.3386634,37.34852429,4
BBQ 대광점,5,5,127.1072292,38.18418643,10
BBQ 동서울터미널점,5,5,127.0941838,37.53461032,10
BBQ 용인구성점,5,5,127.1087251,37.29804624,10
BBQ 자양3점,4,4,127.0683295,37.53559038,8
BHC치킨 대학로본점,5,5,127.0024092,37.58270073,10
BHC치킨 송파구청점,1,1,127.1095641,37.51433892,2
BHC치킨 에버랜드점,2,3,127.2000476,37.29183431,5
BHC치킨 포천일동점,1,1,127.3168838,37.95583747,2
BLT스테이크,5,5,127.0087433,37.57044961,10
BMW 한독모터스 수원전시장,4,4,127.0970678,37.26933666,8
BOB,4,4,127.6296915,37.24885771,8
BS호텔,4,4,126.7859634,37.64353868,8
Backstreet 9,4,3,126.8028655,37.55894903,7
Bar032,2,4,126.623662,37.47208732,6
C27 가로수길본점,5,5,127.0232441,37.52073412,10
CCC,5,5,126.9681491,37.5946222,10
CGV DRIVE IN 곤지암,4,5,127.2990463,37.33616717,9
CGV 강남,5,5,127.0263912,37.50165739,10
CGV 강릉,5,5,128.898238,37.75562402,10
CGV 동수원,4,4,127.03231,37.26390633,8
CGV 명동,5,5,126.982583,37.56349296,10
CGV 부천,8,8,126.7604964,37.50436023,16
CGV 북수원,5,5,127.0074851,37.30354,10
CGV 수원,5,5,127.0001691,37.26655259,10
CGV 압구정 본관,8,7,127.0286471,37.52455679,15
CGV 용산아이파크몰,43,43,126.9639508,37.52975174,86
CGV 인천도화,4,4,126.6645433,37.46953717,8
CGV 인천연수,9,9,126.6830889,37.40635534,18
CGV 파주야당,2,3,126.7600925,37.71313712,5
CGV 평택소사,4,4,127.1114917,37.00046166,8
CGV 피카디리1958,5,5,126.9913133,37.57099382,10
CGV 하남미사,4,4,127.1922605,37.56359269,8
CJ오피스텔,4,4,126.9476943,37.47980834,8
CN스파,5,5,126.9983263,37.49979345,10
CS에비뉴호텔,1,1,126.9364817,37.59908443,2
CS프리미어호텔,20,20,126.9169269,37.41598092,40
CS호텔,6,6,126.9299185,37.60861679,12
CU SK대호주유소점,3,3,127.056717,37.29659948,6
CU 광교중흥점,5,5,127.0558958,37.28415744,10
CU 광주궁평점,4,4,127.3236992,37.33802958,8
CU 구리유탑유블레스점,4,4,127.1352839,37.60108545,8
CU 남이천IC점,3,3,127.4397721,37.18093882,6
CU 남한산성점,2,3,127.1695768,37.46253941,5
CU 동대문역점,3,3,127.0109666,37.57127114,6
CU 동대입구역점,5,5,127.005161,37.55931712,10
CU 메이필드호텔점,4,4,126.8191691,37.54714684,8
CU 면목7동점,3,3,127.0876285,37.57921472,6
CU 미사로또점,4,4,127.1980241,37.5645211,8
CU 방이스타점,3,3,127.1105885,37.5156246,6
CU 베르누이호텔점,5,5,126.8459727,37.49743332,10
CU 부개SK뷰점,4,4,126.7368975,37.49348537,8
CU 서울숲L타워점,3,3,127.0852911,36.99098236,6
CU 서하남휴게소판교방향점,5,5,127.1930688,37.52592515,10
CU 성북삼선점,5,5,127.0108193,37.58615918,10
CU 속초청초호점,3,3,128.5806584,38.1948245,6
CU 송도웨스턴파크점,5,5,126.6289612,37.40603929,10
CU 송도유원지점,5,5,126.6501015,37.41844044,10
CU 아침고요수목원점,6,6,127.3928014,37.76453863,12
CU 안산대부점,6,6,126.5696039,37.26937981,12
CU 압구정역점,5,5,127.0291287,37.52677314,10
CU 원남사거리점,5,5,126.9979669,37.57562884,10
CU 은평어드벤스힐점,4,3,126.9187913,37.63358143,7
CU 이태원하얏트점,2,5,126.9951708,37.539351,7
CU 종로가회점,4,4,126.9852461,37.58151683,8
CU 중구청점,4,3,126.9987459,37.56287075,7
CU 중앙박물관점,4,4,126.9777712,37.52270211,8
CU 춘천남산점,2,2,127.6468453,37.79045193,4
CU 파주영태본점,3,4,126.7897446,37.77636864,7
CU 파주이채점,3,3,126.6874413,37.71482741,6
CU 포천장암점,3,3,127.3682431,38.03858477,6
CU 포천중앙점,5,5,127.2034246,37.89888141,10
CU양평블룸비스타점,5,5,126.5259428,33.51421389,10
Coco 카페,3,3,126.8355379,37.5530096,6
DDP패션몰,5,5,127.0121567,37.56731745,10
DMYK,10,10,127.0208023,37.57537114,20
DMZ 장단콩두부마을,16,15,126.6896479,37.78613016,31
DMZ마루캠핑장,5,5,127.019313,38.13491646,10
DMZ생생누리,7,9,126.7403683,37.89042992,16
DW스테이,2,2,126.9220719,37.5611764,4
DYD오피스텔,5,3,127.1310403,37.53947121,8
ESC방탈출카페 홍대점,4,4,126.9225253,37.55181713,8
EXCO,4,4,128.6130635,35.90720842,8
FB씨어터,5,5,127.0730857,37.51430045,10
G7,5,5,126.4720167,33.49756885,10
G7호텔,25,27,127.0970055,37.35183809,52
GS25 G여의도점,5,5,126.9254663,37.53047615,10
GS25 S9동작역점,3,3,126.9779376,37.50306746,6
GS25 S김포공항역점,4,3,126.8012766,37.56231429,7
GS25 가좌대우점,4,3,126.7181238,37.68808461,7
GS25 강남대행복점,5,5,127.1297177,37.27680565,10
GS25 강남쌍용점,3,3,127.0299614,37.49567296,6
GS25 강일4단지점,3,3,127.1771731,37.56657246,6
GS25 계동중앙점,3,3,126.9865596,37.58004296,6
GS25 고색밸리점,4,3,126.9868731,37.2386253,7
GS25 곤지암리조트점,13,13,127.2963727,37.33750561,26
GS25 곤지암목방점,3,3,127.350831,37.34415761,6
GS25 곤지암점,3,3,127.3417492,37.35004716,6
GS25 구로계영점,2,3,126.886263,37.48841486,5
GS25 기흥롯데점,4,3,127.1027835,37.27151776,7
GS25 대치삼호점,3,3,127.0661516,37.50872733,6
GS25 덕이포인트점,2,2,126.7341864,37.7008797,4
GS25 도화동아점,5,5,126.6654597,37.46531584,10
GS25 명동IB점,5,5,126.9862279,37.56157973,10
GS25 미사파라곤점,3,3,127.1935982,37.56396261,6
GS25 방배서문점,4,4,126.9830989,37.48944509,8
GS25 서수원자이점,4,3,126.9603631,37.29657399,7
GS25 서신이편한점,4,3,127.1241615,35.82884364,7
GS25 선재대교점,4,4,126.5334736,37.23348803,8
GS25 설봉호수점,5,5,127.4355827,37.27885413,10
GS25 성남포레점,5,4,127.149493,37.45454752,9
GS25 성내이안점,4,5,127.12806,37.53548305,9
GS25 송도쉐라톤점,5,4,126.6452598,37.39016294,9
GS25 수원행리단길점,11,11,127.0132073,37.28522141,22
GS25 신광명역점,5,5,126.8546395,37.48116131,10
GS25 신포로데오점,3,3,126.6256296,37.47173767,6
GS25 안산중앙역점,5,5,126.839119,37.31393335,10
GS25 안성롯데캐슬점,3,3,127.2256629,37.01311646,6
GS25 압구정신사점,3,3,127.0302261,37.52121187,6
GS25 여주연라점,3,3,127.6061786,37.25643645,6
GS25 외대스타점,3,3,127.0599825,37.59575621,6
GS25 용인동부점,4,4,127.2232346,37.22420394,8
GS25 용인신갈점,3,3,127.1094217,37.27671081,6
GS25 원주라온점,5,5,127.8736647,37.38266708,10
GS25 인계센트럴점,3,3,127.0339106,37.26319405,6
GS25 제부중앙점,5,4,126.6582057,37.17216135,9
GS25 청평대교점,3,3,127.40983,37.72799796,6
GS25 출판도시점,4,4,126.6870912,37.70853771,8
GS25 충무로본점,5,5,126.9931231,37.56081719,10
GS25 파주프로방스점,4,4,126.6866133,37.78963407,8
GS25 포천삼정점,3,3,127.1244778,37.96089674,6
GS25 한강반포1호점,4,3,127.0022938,37.51281206,7
GS25 향남로드점,5,5,126.891081,37.08940286,10
GS25 홍은중앙로점,4,4,126.9487603,37.60074462,8
GS더프레시 송도그린워크점,4,4,126.6427032,37.40158014,8
GS더프레시 위례중앙점,3,3,127.1428183,37.47370495,6
GS칼텍스 신길주유소,2,3,126.9087198,37.49903739,5
GS타워,3,3,127.0373341,37.50194637,6
GV,4,4,127.0166811,37.28248902,8
G게스트하우스,5,6,126.9949619,37.53320887,11
G밸리소홈오피스텔,5,5,126.9001246,37.48665781,10
G타워전망대,4,3,126.6342006,37.39608587,7
H&M 명동중앙길점,3,3,126.9851184,37.56354737,6
H&M 송도 트리플 스트릿점,2,2,126.6594768,37.38094585,4
H&M 용산 아이파크몰점,4,4,126.9646975,37.52967268,8
H&M 홍대점,3,4,126.9224953,37.55454173,7
HL호텔,10,10,127.1100455,37.51557195,20
HOTEL 166,4,5,127.0350502,37.26540308,9
Hall1,3,3,126.8946911,37.54015469,6
H에비뉴 건대점,10,10,127.06661,37.54602854,20
H에비뉴 성신여대점,4,4,127.0190411,37.59413102,8
H에비뉴 이대점,11,12,126.9425752,37.55622185,23
I GO 동전노래연습장,1,1,126.7817981,37.48528757,2
IFC몰,106,108,126.9005944,37.34930851,214
IMT모텔,12,12,126.9903004,37.56905119,24
IMT호텔,7,7,126.9188957,37.50420851,14
JBD종로빈대떡 낙원점,7,7,126.9888907,37.5719293,14
JK블라썸호텔,8,10,126.8678789,37.55691153,18
JK아트컨벤션,5,4,126.9000731,37.51767938,9
JS부티크호텔,4,4,126.8688565,37.47427621,8
JTN아트홀 2관,5,5,127.0039305,37.57664511,10
JW 메리어트 호텔 서울,13,13,127.0046935,37.50404431,26
JW메리어트 호텔 서울 이그제큐티브 라운지,5,5,127.0046935,37.50404431,10
JW메리어트동대문스퀘어서울,44,45,127.0087478,37.57023337,89
JW메리어트동대문스퀘어서울 더라운지,2,4,127.0087613,37.57017751,6
JW메리어트동대문스퀘어서울 타볼로24,8,9,127.0087387,37.57044781,17
JW메리어트호텔서울 더라운지,3,3,127.0046822,37.50400827,6
JW메리어트호텔서울 플레이버즈,10,10,127.0046641,37.504038,20
Jajam157 카페,4,4,127.4910253,37.6900687,8
Jjs house,5,5,126.9825924,37.5843101,10
K-water 한탄강댐 물문화관,10,10,127.1284509,38.06302607,20
KBS아레나,1,1,126.8479626,37.55675872,2
KB국민은행 부평종합금융센터,5,5,126.7233626,37.49328866,10
KB국민은행 압구정역지점,3,3,127.0271782,37.52631589,6
KB국민은행ATM 양평동종합금융센터점,3,3,126.8975817,37.53630095,6
KB청춘마루,5,5,126.9230072,37.55422131,10
KFC 광화문점,2,2,126.9759478,37.57152508,4
KFC 대학로점,5,5,127.0022914,37.58187452,10
KFC 동대문점,5,5,127.0107085,37.57125855,10
KFC 서초동점,8,8,127.0151284,37.48497993,16
KFC 안양일번가점,3,3,126.9222344,37.40024551,6
KFC 영등포역점,3,3,126.907727,37.5154313,6
KFC 용인에버랜드점,5,5,127.2014359,37.2926573,10
KFC 웅진플레이도시점,4,4,126.7438779,37.50042402,8
KFC 홍익대점,4,4,126.9231502,37.55600898,8
KPOPSTAR코인노래연습장,5,5,126.9717789,37.54399328,10
KT&G상상마당 홍대,14,15,126.9210685,37.55100888,29
KT플라자 홍대애드샵플러스점,3,3,126.924591,37.55706228,6
K스타PC카페 북성동점,3,3,126.6181091,37.47565731,6
K현대미술관,3,3,127.0391332,37.52434988,6
K호텔,3,3,127.282763,37.39150755,6
L7 강남,11,13,127.0517538,37.5057648,24
L7 명동,14,14,126.9869886,37.5613843,28
L7 홍대,10,10,126.9215616,37.555698,20
L7 홍대 21층 라운지,3,3,126.9215616,37.555698,6
LA코코보일링 본점,5,5,126.6865102,37.3414954,10
LCDC서울,38,39,127.061546,37.54173532,77
LF스퀘어 양주,4,5,127.0522939,37.83139323,9
LF스퀘어 양주점,4,4,127.0522916,37.83139233,8
LG아트센터 서울,3,4,126.8292781,37.56536922,7
LH서울양원1단지아파트,4,4,127.1071161,37.60900254,8
LP바 제플린,5,5,127.0229401,37.50324028,10
LP음악카페 아바,5,4,126.7360224,37.39824285,9
LS용산타워,4,4,126.967814,37.5279887,8
LX22베이커리카페,12,13,127.4794416,37.65847525,25
M&M펜션,10,10,127.379946,37.68119989,20
MBC드림센터,4,5,126.7705505,37.65563873,9
MBC신사옥,2,4,126.8903698,37.58117853,6
MLB 인천점,3,3,126.6279464,37.47232524,6
MPX갤러리,2,3,126.9259604,37.52505513,5
MUL호텔,3,3,127.0352977,37.50511493,6
MUNIVERSE,3,3,128.6367967,35.78801417,6
MY24모텔,10,11,126.6256582,37.46941407,21
M모텔,4,4,126.9808431,37.47603503,8
NAVER그린팩토리,3,3,127.1050176,37.35953059,6
NC백화점 강서점,9,8,126.8405167,37.55997536,17
NC백화점 고잔점,4,3,126.8310157,37.31353101,7
NC백화점 불광점,4,3,126.9289208,37.60970729,7
NC백화점 야탑점,4,4,127.1274816,37.4109281,8
NC큐브 커넬워크 겨울동,3,4,126.6396162,37.40188793,7
NC큐브 커넬워크 봄동,2,2,126.6353845,37.39789246,4
NC큐브 커넬워크 여름동,7,7,126.6364745,37.39901308,14
NOSH,3,4,126.9117645,37.48523177,7
North124,3,3,127.3028603,37.53634353,6
OK마트 양수점,2,2,127.3191044,37.54405924,4
Ofr 서울,11,12,126.9717992,37.58012145,23
P1904,5,5,126.9517968,37.54199741,10
PB가평휴게소상행선,4,4,127.0669254,37.28422019,8
PC토랑 용죽점,2,3,127.1255172,36.99244244,5
PEEK,3,4,127.0468352,37.48045306,7
PJ호텔,24,24,126.9957215,37.56479161,48
Paint Coffee&Bar,5,5,127.0046196,37.58917971,10
R&J씨어터,5,5,127.0052756,37.5803067,10
R52,3,3,127.631793,37.30019057,6
RPM,4,4,127.0390072,37.52667118,8
RSG,9,8,127.0599376,37.5425448,17
Refresh,5,5,126.5534492,33.4807173,10
R게스트하우스,13,13,126.9892143,37.57302359,26
S-OIL 수원,5,5,126.9590151,37.29279458,10
S2A,3,3,127.0656232,37.50339908,6
SAVVY,4,4,127.1051871,37.50817373,8
SETEC,4,4,127.072197,37.49590067,8
SH아트홀,6,7,127.0035684,37.5798887,13
SK주유소팝업스토어,8,9,126.9841846,37.56894241,17
SK행복충전 송내IC충전소,3,3,126.7506364,37.48335813,6
SOFA,5,5,126.881792,37.41814589,10
SPACE R,4,3,127.0333064,37.52883533,7
SRT수서역 주차장,5,5,127.1058119,37.48530834,10
SR디자인호텔,24,25,127.2065806,37.23481244,49
Stdo,3,3,127.0420564,37.54740846,6
Studio 19,10,8,127.0352575,37.4862203,18
S마트,5,5,127.0373915,37.20787596,10
S쁘띠호텔,4,4,127.7245764,37.86946222,8
S스테이호텔,8,7,127.0031343,37.26879614,15
S호텔,1,1,127.0766911,37.61645128,2
T7호텔,5,5,127.2090284,37.23646787,10
TROUBADOUR 이태원점,8,7,126.9935871,37.53474501,15
TROUBADOUR 홍대점,4,3,126.9251507,37.55645716,7
TWG Tea 잠실 롯데 에비뉴엘 월드타워점,5,5,127.1017483,37.51281061,10
Tesla 충주 수퍼차저,3,3,127.8351705,37.00108271,6
T타워,5,5,126.9756275,37.55391233,10
T팩토리,9,10,126.9223949,37.55534536,19
W몰,7,7,126.8879393,37.47743857,14
W지우리조트,4,4,127.5232845,37.79979393,8
XYM 월곶점,3,3,126.7406296,37.39055113,6
YC글램핑,5,5,126.96602,38.0382214,10
YH1커피,4,4,126.9252079,37.57394733,8
Y호텔,5,5,126.9363214,37.55335077,10
ZARA 롯데아울렛서울역점,5,4,126.9709363,37.55460324,9
cj 햇반 팝업스토어-쌀창고등학교,4,4,129.2683951,35.86073309,8
coffee box,3,3,126.7528584,33.38870699,6
e편한세상부평역센트럴파크아파트,3,3,126.7156701,37.48665522,6
e편한세상시티미사오피스텔,16,16,127.1899675,37.56453434,32
e편한세상신곡포레스타뷰아파트,8,8,127.0678322,37.74425959,16
h'654 현대프리미엄아울렛 김포점,4,4,126.785193,37.59744914,8
h키친 현대프리미엄아울렛김포점,4,4,126.7855785,37.59927795,8
jw메리어트9층 라운지,5,5,127.7120528,37.88463102,10
jw메리어트서울,5,5,127.0429371,37.51703215,10
m365카페,3,4,126.4244399,33.24131911,7
mtl 효창,5,5,126.9609169,37.54200619,10
srt수서,5,5,127.0429371,37.51703215,10
srt수서역,5,5,127.0574929,37.2846117,10
story A,5,5,126.9991639,37.53626607,10
zara 강남역점,5,5,127.0250976,37.50219107,10
zara 눈스퀘어점,4,4,126.9824574,37.56351457,8
zara 롯데월드몰점,4,3,127.1040841,37.51369155,7
zara 롯데잠실점,4,4,127.0985619,37.51188347,8
zara 트리플스트리트점,3,3,126.6593946,37.38091318,6
ㅊa 차이나타운점,9,9,126.6191743,37.47382179,18
가구공감,4,5,126.9329706,37.51898025,9
가나아트센터,5,5,126.9751192,37.61230741,10
가나아트파크,4,4,126.9496635,37.72556692,8
가나아트파크 미술관,5,5,126.9487518,37.72519173,10
가나아트파크 아트놀이터,5,5,126.9490691,37.72569641,10
가나아트파크 야외공연장,5,5,126.9496364,37.72540834,10
가나아트파크 어린이체험관,5,5,126.9497493,37.72621926,10
가나아트파크 조각공원,3,5,126.9496815,37.72586605,8
가나안초계국수,3,3,126.8279421,37.60093306,6
가네끼스시,3,5,126.9241461,37.49124468,8
가능솔밭숯불갈비,3,3,127.0346569,37.74766796,6
가둘기정원펜션,8,9,127.5163301,37.90033737,17
가드너스,12,13,126.6961725,37.78964289,25
가든파이브,9,9,127.1246444,37.47782241,18
가든파이브라이프 영관,4,4,127.1260471,37.47694514,8
가든포에트,9,9,126.9237401,37.55018892,18
가디온,6,7,127.3120774,37.39285293,13
가락동농수산물도매시장 수산시장,5,5,127.1088587,37.49280555,10
가락몰,4,4,127.1161542,37.49409425,8
가람,12,11,127.3159662,37.53350799,23
가람마을3단지동문아파트,5,2,126.7582478,37.73181317,7
가래골농원 캠핑장,8,8,127.1592808,37.99385591,16
가로수브루잉컴퍼니,5,5,127.022013,37.51949097,10
가리비칼국수,3,3,126.671179,37.43854308,6
가림중학교,5,5,126.8796818,37.45763705,10
가마솥 뼈다귀해장국,4,4,129.1185617,35.55688123,8
가마솥족발 순대국,5,5,126.9771221,37.5514511,10
가메골손왕만두 남대문본점,5,5,126.9771155,37.55835455,10
가미우동,5,5,126.9238577,37.55468317,10
가배도 명동점,5,5,126.9850262,37.5604191,10
가배도 삼청점,10,10,126.982158,37.57990723,20
가보자순대국,2,3,127.7460514,37.92631709,5
가보정 2관,5,5,127.0281653,37.27449642,10
가보호텔,1,1,127.112885,36.99306065,2
가비가배,20,21,127.320375,38.07468958,41
가비림,5,3,127.0158253,37.28270539,8
가산농협하나로마트 내촌점,3,3,127.2281685,37.78568189,6
가산디지털단지,4,4,126.8869406,37.47699432,8
가산디지털단지역 7호선,29,31,126.8826618,37.48039597,60
가야,9,10,126.9192646,37.67874312,19
가야역 부산2호선,3,3,129.0433135,35.15593532,6
가양칼국수,7,7,126.9314061,37.52089416,14
가온길,13,13,127.4588144,37.77081764,26
가온칼국수 송도본점,5,5,126.6606635,37.38246118,10
가요리믹스 별밤,5,5,126.9061805,37.51836375,10
가우딘악세사리부품상가,8,7,126.9758266,37.55765061,15
가운문화공원,2,4,127.1586238,37.60243671,6
가이오국수 본점,5,5,126.9172908,37.61054394,10
가자모텔,5,5,127.1334552,37.43408126,10
가자실내낚시카페 대학로점,5,5,127.0039885,37.5816186,10
가장맛있는족발 등촌역점,5,5,126.8638103,37.55065687,10
가장맛있는족발 안양덕천점,4,4,126.93081,37.39638726,8
가정집백반,4,3,126.5449282,33.49876688,7
가좌이음숲,3,3,126.6859532,37.48316156,6
가챠샵 신도림테크노마트점,5,5,126.8902565,37.50710189,10
가챠샵 차이나타운점,4,3,126.6178455,37.47568438,7
가천대학교 글로벌캠퍼스,4,2,127.1299445,37.45041696,6
가천린포크 김포점,10,10,126.717564,37.61260995,20
가천컨벤션센터,3,3,127.1271856,37.44961445,6
가평 JH풀빌라,5,5,127.540523,37.75805241,10
가평 뉴청평펜션,5,6,127.4339538,37.73747176,11
가평 도그랜드카라반,5,5,127.3553238,37.83596824,10
가평 숲으로가는길 펜션,6,6,127.3807172,37.7759664,12
가평 이든펜션,6,6,127.437366,37.99505691,12
가평 조은마트,31,32,127.5163156,37.82398813,63
가평가보자순대국밥,9,9,127.5125568,37.82573076,18
가평계곡,5,4,127.456191,37.820916,9
가평고등학교,4,4,127.513123,37.81827025,8
가평군농협하나로마트 본점,24,23,127.5141732,37.83017079,47
가평군농협하나로마트 북면점,9,10,127.5488846,37.88386159,19
가평군농협하나로마트 설악점,9,9,127.4914541,37.67768139,18
가평군농협하나로마트 자라점,7,6,127.5150275,37.81449057,13
가평군농협하나로마트 조종점,11,10,127.3488305,37.81765508,21
가평군농협하나로마트 청평점,42,44,127.4151943,37.73510312,86
가평군어린이음악놀이터,5,5,127.5132748,37.82641236,10
가평달맞이밥상,5,5,127.364124,37.76626507,10
가평달맞이빵,12,12,127.3644198,37.76641552,24
가평대교,3,3,127.4955623,37.7042752,6
가평레일파크,52,53,127.5158437,37.82897063,105
가평레저파크,5,4,127.5529989,37.89167688,9
가평메밀촌 가평점,3,3,127.5143973,37.81663398,6
가평명품잣순두부,4,5,127.3630397,37.76270421,9
가평뮤직빌리지 음악역1939,16,16,127.5132455,37.82447725,32
가평브릿지짚라인,2,3,127.4675111,37.83427177,5
가평빠지이비자수상레저,4,4,127.5409784,37.75700521,8
가평산토리니펜션,10,10,127.3805596,37.7617754,20
가평소나무펜션,3,4,127.4108065,37.75322064,7
가평손두부,8,8,128.3247646,36.54613122,16
가평숯불막국수 본점,8,8,127.5128649,37.74873397,16
가평양떼목장,5,5,127.4720015,37.64361034,10
가평양떼목장카페,14,14,127.4737365,37.64382863,28
가평역 경춘선,142,142,127.5107394,37.81452005,284
가평용추계곡 공영주차장,5,5,127.4796083,37.86009466,10
가평잣고을낭만음악회,4,4,126.3859695,33.31927276,8
가평잣고을시장,26,27,127.515052,37.82978135,53
가평잣고을시장닭갈비,4,3,128.6378384,35.89984054,7
가평잣소라네농원,4,4,127.5230815,37.87430299,8
가평잣진우농산,2,2,127.5050506,37.84497496,4
가평초등학교,2,4,127.5072536,37.83071704,6
가평축협한우명가,5,5,127.5163099,37.81598774,10
가평탑랜드,9,10,127.5260289,37.80604151,19
가평터미널,6,6,127.5154657,37.82459008,12
가평토속메밀전,4,4,127.515206,37.8297158,8
가평프리미엄키즈풀빌라,8,8,127.3454048,37.86114953,16
가평휴게소,4,4,127.8146745,37.95207868,8
가평휴게소 서울방향,22,22,127.5435148,37.70161689,44
가평휴게소 춘천방향,9,9,127.5468237,37.70193315,18
가평힐링레저 글램핑&캠핑,5,5,127.5361092,37.77227523,10
가평힐링캠프,13,11,127.0998163,34.91246721,24
가현생고기 장기점,3,3,126.6813666,37.6470218,6
가회동백인제가옥,11,13,126.984173,37.58081752,24
가회동성당,3,4,126.9845667,37.58205734,7
간석오거리역 인천1호선,4,5,126.7079185,37.46708267,9
간이역,11,11,127.4336931,37.5156442,22
간코,9,9,127.1113045,37.51642042,18
간현관광지,5,5,127.8340397,37.36459081,10
갈데,5,5,127.0118335,37.51327911,10
갈릴리농원 본관,5,5,126.7456833,37.83578099,10
갈매울감자탕,5,5,126.9504503,37.50440342,10
갈비1987,16,17,127.3662176,38.03214006,33
갈비도락 미사본점,4,4,127.2090804,37.55486319,8
갈비명가서서갈비,4,4,127.0281426,37.27398283,8
갈비장터,6,6,127.1451364,37.82690434,12
갈피책방,5,5,126.656552,36.69399421,10
감고당길,26,26,126.982317,37.57798093,52
감나무집,5,5,127.3027202,37.51736976,10
감성216,5,5,127.4703419,37.73287422,10
감성교복 롯데월드점,14,14,127.0974426,37.51225742,28
감성교복 잠실본점,4,4,127.1027365,37.50764519,8
감성식탁,7,10,127.6445896,37.28905882,17
감성타코 가로수길점,4,5,127.0232709,37.51962048,9
감성타코 건대점,5,5,127.0699345,37.54352184,10
감성타코 광화문점,3,4,126.9724428,37.57257667,7
감성타코&그릴 합정점,5,5,126.9123649,37.55099643,10
감악산,10,13,126.9699212,37.94121922,23
감악산 복칼국수,4,3,126.927095,37.95658849,7
감악산등산코스,4,4,126.9583662,37.94350769,8
감악산출렁다리,4,4,126.9455323,37.93888604,8
감일스윗시티10단지아파트,4,4,127.1617023,37.50838469,8
감일한라비발디아파트,5,5,127.1618248,37.50281181,10
감자옹심이,8,7,127.1544526,37.6531389,15
감탄계숯불치킨 자양점,5,5,127.0805607,37.53699454,10
감탄떡볶이 송내점,2,2,126.7528643,37.49005278,4
갓덴스시 롯데몰김포공항점,4,4,126.8031622,37.5631824,8
갓덴스시 종로점,10,10,126.9856062,37.56947598,20
갓잇 송리단길점,5,5,127.1113262,37.50965206,10
갓지은솥밥,4,4,127.3017812,37.63345319,8
강&한인테리어,19,20,126.7911344,37.49612012,39
강강술래 상계지점,4,4,127.0560304,37.67384386,8
강경불고기 본점,5,5,127.0549751,37.70614438,10
강경해물칼국수,2,2,127.0154294,36.15745824,4
강구미주구리,3,3,126.97303,37.57658443,6
강나루민물매운탕,5,5,127.3761168,37.6439622,10
강남고속버스터미널 광장주차장,4,4,127.0077586,37.50670211,8
강남교자 중계홈플러스점,5,5,127.0686696,37.63985664,10
강남구 선릉로 829,2,4,127.0397998,37.5261243,6
강남구청역 7호선,13,13,127.0413109,37.51721617,26
강남구청역 수인분당선,3,3,127.041504,37.51662414,6
강남구탄천공영주차장,4,4,127.0681896,37.50870995,8
강남대입구교차로,5,5,127.1276392,37.27187021,10
강남대학교,5,5,127.1331542,37.27603234,10
강남면옥 수원점,4,4,126.9902807,37.31079858,8
강남빠우,5,5,126.8948128,37.51312475,10
강남센트럴안과의원,3,3,127.0480197,37.50466625,6
강남수상레져,3,4,127.0176756,37.52765118,7
강남역 2호선,21,21,127.0280014,37.49808634,42
강남역 스파오,4,4,127.0266415,37.5012747,8
강남역 신분당선,6,6,127.0281852,37.49677713,12
강남역사거리,15,14,127.0276383,37.49795217,29
강남역지하상가,22,22,127.0278418,37.49773588,44
강남클럽 잭&리빈,4,4,127.020532,37.51436813,8
강남할배제빵소,5,5,126.6887042,37.34745787,10
강남회조개구이,7,7,126.3730875,37.4468721,14
강너머남촌 숯불닭갈비 방배점,5,5,126.9839694,37.49528734,10
강동공동체정원,3,3,127.1324625,37.55793107,6
강동구립 성내도서관,5,5,127.1333413,37.5328607,10
강동그린타워,5,5,127.1381132,37.5345686,10
강동리버스타운,5,5,127.1292303,37.54297989,10
강동상떼빌아파트,5,3,127.1304205,37.53701217,8
강릉감자옹심이 강릉본점,4,4,128.8949081,37.75647397,8
강릉고속버스터미널,3,3,128.8798149,37.75466904,6
강릉대관령휴게소 강릉방향,5,5,128.8065653,37.75732481,10
강릉동화가든 속초직영점,4,4,128.5799202,38.19520738,8
강릉역,18,18,128.8996276,37.76452356,36
강릉월화거리,3,5,128.8974965,37.75590982,8
강릉웨이블루스파펜션,3,3,128.83225,37.90028344,6
강릉중앙시장,9,9,128.8986238,37.75402512,18
강릉해변메밀막국수,5,5,126.9679395,37.28697483,10
강릉해변메밀막국수 인천검단점,1,1,126.6759976,37.58705927,2
강릉해변메밀막국수 하남점,9,9,127.2001724,37.52263909,18
강릉형제장칼국수 서울점,4,4,126.9383961,37.46900976,8
강마을다람쥐 덕소점,4,4,127.2269443,37.5689551,8
강매역 경의중앙선,9,7,126.8444982,37.61229047,16
강문해변,9,9,128.9191753,37.79482074,18
강민주의들밥,10,10,127.3679314,37.22151453,20
강민주의들밥 송도점,5,5,126.6333286,37.393809,10
강변로 194-11,4,4,126.5640039,33.24761378,8
강변비치모텔,4,4,127.2203388,37.57525024,8
강변역 2호선,29,28,127.0947411,37.53511804,57
강변역포장마차10번,5,5,126.6532616,37.18619256,10
강변역포장마차8번,1,1,127.0943198,37.53658791,2
강산닭갈비,3,3,127.3495276,37.81831792,6
강서한강공원,2,3,126.8131252,37.58837414,5
강씨네즉석떡볶이 장안본점,1,3,127.0674388,37.56668974,4
강씨봉자연휴양림,10,10,127.4089924,37.96948251,20
강우수산 옥련점,4,4,126.6474415,37.42293761,8
강원과학고등학교,10,10,127.9722687,37.37596174,20
강원도막국수,4,4,127.0032583,37.26994947,8
강이다,1,1,127.3202496,37.55042797,2
강천섬유원지,21,22,127.695992,37.23284652,43
강촌가스충전소,5,5,127.6201573,37.82702246,10
강촌레일파크 김유정역,3,4,127.7120333,37.81597448,7
강촌식당 방이점,8,8,127.1094832,37.51476067,16
강촌테마랜드,3,3,127.6347847,37.81441421,6
강하예술공원,3,3,127.4141302,37.49863508,6
강화도 에코스파펜션 & 글램핑,5,5,126.492769,33.50707896,10
강화씨사이드리조트 루지,5,5,126.8028655,37.55894903,10
개구리커피,4,4,127.524837,37.87568262,8
개군할머니 토종순대국 본점,4,4,127.5377597,37.42586225,8
개나리교,5,5,127.1111662,37.39858978,10
개나리아구찜 송파점,2,2,127.1186079,37.51113343,4
개나리어린이공원,4,4,126.5005483,37.25752133,8
개미어린이공원,4,4,127.077827,37.62062752,8
개미촌,5,5,127.1675882,37.54179823,10
개봉역 1호선,6,6,126.858716,37.49464172,12
개뿔,4,4,127.0080695,37.57819101,8
개성곱창 향남점,3,3,126.915463,37.11734229,6
개성만두 궁,5,5,126.9853924,37.57428367,10
개성설렁탕,3,3,127.0432485,37.73205673,6
개성손만두,3,2,126.6703951,37.44001856,5
개성손만두 파주점,5,4,129.0833274,35.55870113,9
개성인삼농협하나로마트 본점,5,5,127.1909765,37.88546557,10
개울장,3,4,127.0088701,37.60879584,7
개항로통닭,3,3,126.6346313,37.47295518,6
개항면,8,8,126.6345162,37.47243044,16
갠지스,8,9,127.0528493,37.29456493,17
갤러리 그리브스,5,5,126.7321866,37.897116,10
갤러리 아트사이드,5,5,126.9729478,37.57826747,10
갤러리구조,4,3,127.057273,37.53836323,7
갤러리도스,1,3,126.9797773,37.58375229,4
갤러리모아,5,5,126.7002676,37.78763703,10
갤러리소연카페,3,3,126.9915888,37.57682868,6
갤러리아백화점 EAST점,10,9,127.0418814,37.52797665,19
갤러리아백화점 WEST점,14,13,127.0401439,37.52842775,27
갤러리아백화점 광교점,51,50,127.057243,37.28525696,101
갤러리아백화점 센터시티점,4,4,127.1047111,36.80056124,8
갤러리아백화점 타임월드점,3,3,127.3781779,36.35181279,6
갤러리카페446,2,2,127.2885977,37.52852435,4
갤러리카페밀,1,1,126.7920968,37.6740109,2
갤러리힐링카페,3,3,127.0766656,37.61919751,6
갤럭시하우스,5,5,127.4958239,37.91734519,10
갯골생태공원 염전체험장,5,5,126.7797647,37.39211177,10
갯배st 속초청년몰,5,5,128.5921842,38.2021329,10
갯벌체험장,5,5,126.5756172,37.2884689,10
갯촌칼국시,5,5,126.9894102,37.72414645,10
갱고개,4,4,127.9426597,36.974395,8
갱변숯불구이,4,4,127.32049,37.54417802,8
갸우뚱,2,3,127.000394,37.58158262,5
거기모텔,4,4,126.7338405,37.77280135,8
거리공원,3,3,126.8917061,37.49949875,6
거마산,4,4,126.7661359,37.46681939,8
거먹골한옥펜션,4,4,127.3569853,36.96257885,8
거북섬,6,6,126.6790857,37.32108522,12
건강보험심사평가원 의정부지원,3,3,127.0952982,37.74483072,6
건강한우리,5,5,127.0193099,37.40701635,10
건국대학교 농축대학원,5,5,127.0745035,37.54101066,10
건국대학교 서울캠퍼스,10,10,127.0773643,37.54351,20
건국대학교 일감호,4,4,127.0763996,37.54074276,8
건대맛의거리,8,8,127.0703618,37.54067803,16
건대입구역 2호선,25,24,127.0692029,37.54040752,49
건대입구역 7호선,8,8,127.0711043,37.5408686,16
건대커피랩,5,5,127.0696604,37.54083703,10
건천휴게소 부산방향,5,5,129.1092185,35.82995981,10
검단산,27,29,127.2519486,37.51981896,56
검은소새끼 수원역직영점,3,4,127.0069721,37.26946635,7
게내수변공원,4,4,127.1715677,37.55806272,8
게스트,1,1,126.9296412,37.48200284,2
게으른 정원,4,4,126.7107417,37.62594963,8
게이트에프앤비 동탄점,4,4,127.0979226,37.20067353,8
겐텐 의정부본점,5,4,127.0495429,37.73988188,9
겟 올라잇,5,5,127.0416036,37.52473314,10
경강교 인증센터,3,5,127.5195102,37.82084239,8
경강막국수,3,4,127.5509563,37.84210955,7
경기과천교육도서관,5,5,126.9966058,37.43232929,10
경기광주휴게소 경기도광주방향,4,4,127.4248518,37.38047475,8
경기광주휴게소 원주방향,10,13,127.4361214,37.37835778,23
경기대학교 서울캠퍼스,4,3,126.9621227,37.56519646,7
경기도 설악면 신천중앙로 ( 세븐일레븐 편의점),5,5,126.9462883,35.9402174,10
경기도국민안전체험관,4,4,127.062829,37.17875579,8
경기도남한산성세계유산센터,8,8,127.1884177,37.47669636,16
경기도농업기술원 (경기도곤충페스티벌),4,4,127.0428634,37.22247021,8
경기도미술관,5,5,126.813958,37.32576667,10
경기도박물관,18,18,127.1086843,37.26808313,36
경기도어린이박물관,14,14,127.1096652,37.267365,28
경기도잣향기푸른숲,10,10,127.3328462,37.76951813,20
경기도청소년수련원,10,10,126.6424187,37.21673105,20
경기도청소년수련원 팔효정,5,5,126.6415692,37.2155263,10
경기둘레길 안성39코스,4,3,127.4752262,37.0739966,7
경기미래교육 파주캠퍼스,5,5,126.6990508,37.78449859,10
경기버스라운지,5,5,126.9814188,37.47482326,10
경기북부 야생동물구조관리센터,4,4,127.0197245,38.00222544,8
경기북부어린이박물관,24,26,127.0643926,37.94476415,50
경기상상캠퍼스,5,5,126.9840721,37.26665063,10
경기서적,3,3,126.9822566,37.29724246,6
경기수원시동부 육아종합지원센터,4,5,127.0806168,37.26661795,9
경기시흥둘레길 53코스,2,2,126.73561,37.3909094,4
경기아트센터,11,11,127.0373595,37.2617982,22
경기아트센터 대극장,5,5,127.0375714,37.26158189,10
경기엘피씨 도축장 직영 판매장,5,5,126.7018417,33.27324563,10
경기옛길 평해길 제4길 두물머리나루길,4,4,127.3352879,37.55163591,8
경기옛길 평해길 제6길 거무내길,5,5,127.5332498,37.46981473,10
경기의왕 레일파크,16,18,126.9507579,37.30943989,34
경기해양안전체험관,15,15,126.580957,37.28954512,30
경동다육,3,3,127.1335067,37.66605931,6
경동시장,10,11,127.0387584,37.57928413,21
경리단그집,3,3,126.988012,37.53849995,6
경리단길,3,3,126.991722,37.53975806,6
경반계곡,15,15,127.4696891,37.83272068,30
경복궁,477,491,126.9726889,37.53963025,968
경복궁 생과방,5,5,126.9782636,37.57978044,10
경복궁 주차장,8,5,126.9789164,37.5773749,13
경복궁돌담 청와대 사잇길,5,5,126.7967866,33.55485535,10
경복궁역 3호선,51,52,126.9736914,37.57580612,103
경북궁,5,5,128.4118029,36.07356926,10
경산역,10,9,128.7279409,35.81934884,19
경성빵공장,20,19,127.1317195,37.50617211,39
경성양꼬치 일산점,4,4,126.76797,37.66332264,8
경성양육관 건대직영점,5,5,127.0656443,37.53912022,10
경성의상실,5,5,126.6189547,37.47543569,10
경수갤러리,9,10,127.0149843,37.28398047,19
경안당,5,5,127.0120075,37.28556573,10
경안시장,3,4,127.2570299,37.40885774,7
경안시장공영주차장,2,3,127.2577707,37.40880928,5
경안천습지생태공원,8,9,127.1218201,35.45831059,17
경양카츠,5,5,126.9893728,37.57291458,10
경양카츠 타임스퀘어점,3,3,126.9037104,37.51717784,6
경원식당 본점,4,4,127.0382976,37.74026447,8
경원재앰배서더,11,12,126.6376842,37.39147528,23
경원재앰배서더 인천,4,5,126.6376842,37.39147528,9
경의선 숲길,3,5,128.9488189,35.17027509,8
경의선숲길,70,68,126.9253385,37.55880348,138
경의선숲길공원,27,28,126.9593071,37.53939454,55
경의선책거리,12,14,126.9294517,37.55618115,26
경인아라뱃길,5,5,126.7449355,37.57379639,10
경인아라뱃길 정서진관광안내소,4,4,126.6072077,37.55804937,8
경인아라뱃길아라마리나 경기인디뮤직페스티벌,5,5,129.041346,35.1161765,10
경인항 김포,4,4,126.7888954,37.59722968,8
경주계림,4,4,129.2189162,35.83257548,8
경주월드,4,5,129.282066,35.83625257,9
경춘선 시간여행 거리,4,4,126.3058389,33.35457233,8
경춘선숲길,23,23,127.078706,37.62069181,46
경춘선숲길 방문자센터,9,9,127.0701391,37.63132885,18
경춘선숲길갤러리,5,5,127.0937088,37.62508127,10
경춘자의 라면땡기는날,2,2,126.9822216,37.57931439,4
경춘철교,4,4,127.0642884,37.63078799,8
경춘폭포,4,4,127.0787828,37.6210089,8
경태네집,3,3,126.9989495,37.57002827,6
경포팔도강산,4,4,128.911111,37.80176912,8
경포해수욕장,4,4,128.9102102,37.80340551,8
경희궁,3,4,126.9686491,37.57078815,7
경희대학교 국제캠퍼스,6,8,127.08119,37.24291021,14
경희대학교 서울캠퍼스,5,5,127.052854,37.59680117,10
계경목장,2,2,127.0022007,37.26661834,4
계남근린공원,3,4,126.8481876,37.51385249,7
계동식당 동탄점,5,5,127.0715101,37.20149525,10
계림 종로본점,10,10,126.9945032,37.57015789,20
계양꽃마루,4,4,126.748072,37.53521529,8
계양산,6,7,126.7145587,37.55316077,13
계양산장미원,4,4,126.7123912,37.54704136,8
계양역 공항철도,5,5,126.7362737,37.57177085,10
계양칼국수,1,2,126.7445628,37.53573033,3
계열사,3,3,126.9656234,37.59286886,6
계절곳간,4,4,129.2604632,35.54697082,8
계정횟집,9,9,127.7746131,37.46895919,18
고가빈커리하우스,3,4,126.9709484,37.57289707,7
고고갈비 홍대상수점,3,4,126.9221219,37.54794258,7
고구려대장간마을,11,13,127.1110578,37.56055522,24
고구려대장간마을 주차장,5,5,127.1104657,37.56125135,10
고구려목장,9,9,126.7590922,35.75771406,18
고구려짬뽕10101 인천계양점,4,4,126.7777859,37.57775328,8
고구려짬뽕집 본점,1,2,126.7747919,37.44399377,3
고구마모텔,8,8,126.9362586,37.55271553,16
고궁의아침,3,3,126.9975774,37.57624151,6
고기랑,3,3,127.0358998,37.2645162,6
고기리막국수,9,10,127.040097,37.3599957,19
고능생선구이시골밥상,4,4,127.0458751,38.00222536,8
고도,3,4,126.9123374,37.56386535,7
고동함박 송리단길점,4,4,127.1064775,37.50892311,8
고동함박 신도림점,5,5,126.8920995,37.51063823,10
고드니(godny),3,3,126.8274534,37.56786593,6
고든램지버거,9,11,127.1016284,37.51284855,20
고등어뱅크,3,3,127.313238,37.36293415,6
고디바 코엑스몰,5,4,127.0584867,37.51317152,9
고랑포구역사공원,12,13,126.8473732,37.98786004,25
고래돈가스 고대점,4,5,127.0350448,37.5883601,9
고래뿌리 선착장,4,4,126.5694535,37.19990549,8
고래산구들 옆 계곡,5,5,127.6577384,37.3984239,10
고래산구들 옆 산양목장,5,5,127.6577384,37.3984239,10
고래옥,4,4,127.4849205,37.67564341,8
고려대학교 서울캠퍼스,8,8,127.0323189,37.58952676,16
고려대학교 서울캠퍼스 중앙도서관,3,3,127.0340994,37.59080026,6
고른햇살,5,5,127.0294601,37.58700473,10
고릴라 캠핑용품 할인매장,3,3,127.6246759,37.29744419,6
고릴라캠핑 가평점,5,5,127.3772492,37.68369703,10
고릴라캠핑 남양주점,5,5,127.1087059,37.64928327,10
고릴라캠핑 용인점,5,5,129.0541053,35.53936925,10
고망고 건대중문점,5,5,127.0714405,37.54227035,10
고매커피,6,8,127.1106526,37.2194393,14
고메스퀘어 동탄점,5,5,127.0978464,37.19654678,10
고모리691,3,3,127.1607281,37.7968714,6
고모리저수지,7,7,127.1634448,37.7983987,14
고모저수지,27,25,127.163311,37.79834182,52
고모호수공원,3,2,127.1642914,37.79397621,5
고목,10,10,127.5257607,37.79190859,20
고베규카츠 서울강남점,2,2,127.0275814,37.50292213,4
고봉민김밥인 과천원문점,4,4,126.9918084,37.42157451,8
고봉민김밥인 인천구월로데오점,4,4,126.7011929,37.44400271,8
고봉민김밥인 화성병점점,5,5,127.0439409,37.21530197,10
고부기 대학로본점,3,3,127.0042704,37.58164652,6
고삼저수지,2,2,127.2823947,37.08149094,4
고석정,12,13,127.287968,38.18525345,25
고석정꽃밭,17,19,127.2950517,38.18700162,36
고성산,5,5,127.1747892,37.04847763,10
고속버스둔산(청사)정류장,9,9,127.3905853,36.36141814,18
고속터미널성당,5,5,127.006994,37.50604623,10
고속터미널역 3호선,5,5,127.005121,37.50454886,10
고속터미널역 9호선,14,13,127.0042118,37.50598149,27
고속터미널지하철역 상가,5,5,127.0050441,37.50465518,10
고시고시,5,5,126.9261897,37.56210166,10
고씨네 고추장찌개,5,5,126.9903792,37.56350106,10
고양관광정보센터,8,9,126.772692,37.65948105,17
고양국제꽃박람회,1,1,126.7687722,37.65389636,2
고양꽃전시관,7,8,126.7687676,37.65390356,15
고양누리길 서삼릉누리길,3,3,126.8684511,37.65875636,6
고양밥할머니공원,3,3,128.3626106,36.97766898,6
고양생태공원,2,2,126.7441381,37.68494366,4
고양시선인장전시관,5,8,126.7613879,37.6575036,13
고양어린이박물관,24,25,126.8310507,37.62942677,49
고양어울림누리,5,5,126.8350618,37.65006768,10
고양어울림누리 얼음마루,5,5,126.8338499,37.65032276,10
고양이카페38.5,1,1,127.1175577,37.66629973,2
고양종합운동장,10,10,126.7431334,37.67648491,20
고양휴게소 문산방향,10,9,126.8522282,37.63059044,19
고양휴게소 서울방향,4,4,126.8494992,37.63112037,8
고요37호텔 오산역점,5,4,127.0697148,37.14533532,9
고요재,15,15,127.3627267,37.76252138,30
고은빛여성병원,5,5,127.1393356,37.53415482,10
고인돌공원,14,14,127.0481841,37.17313105,28
고인돌공원 고인돌광장,5,5,127.0484682,37.17366076,10
고잉투커피,5,5,127.5263812,37.22796245,10
고잔골한방보쌈,1,1,126.8498995,36.9609456,2
고종의 뜰,4,4,126.8125055,37.67736341,8
고종의길,4,4,126.9726755,37.56773631,8
고창집,4,4,127.0053248,37.57057956,8
고척스카이돔,20,20,126.8671048,37.49823385,40
고척스카이돔 VIP주차장,3,3,126.8667313,37.49903442,6
고척스카이돔 옆에 공원,3,2,126.6740754,33.53963391,5
고척스카이돔 전면광장,8,8,126.8681049,37.4992495,16
고촌농협 로컬푸드직매장 장곡점,5,5,126.7530528,37.60575555,10
고카페 용산아이파크몰점,5,5,126.9647427,37.5297736,10
고칸 안양1번가점,3,4,126.9225549,37.40046557,7
고쿠텐 대학로점,4,4,126.9999321,37.58230522,8
고쿠텐 인계점,4,5,127.0353445,37.26317561,9
고킥보드 여의도점,4,4,126.9338306,37.52378489,8
고투몰,9,9,127.0050533,37.50621932,18
고투웍 성수역점,2,3,127.0537955,37.54392584,5
고향가는길,4,4,127.173994,37.59300511,8
고향나들이오리구이,5,5,127.1784361,37.92706917,10
고향산천,3,3,127.3004368,37.72715896,6
고향손칼국수,5,5,127.27279,37.40041773,10
고향집,3,4,127.0030463,37.43620727,7
고향초가집,4,4,127.1658785,37.78679152,8
고향카츠 판교테크노밸리점,4,4,127.0981682,37.41323115,8
곤드레찜드레 용인점,5,5,127.1889166,37.23319302,10
곤지곤지대구탕,2,2,127.3451928,37.34909018,4
곤지암 리조트 생태하천,5,5,127.2968268,37.33706477,10
곤지암 하나정 한우 전문,4,4,127.3169176,37.35960678,8
곤지암도자공원,13,13,127.327352,37.35126732,26
곤지암루지360,13,14,127.2846764,37.33365631,27
곤지암리조트,97,96,127.2940951,37.33798434,193
곤지암리조트 East빌리지,15,15,127.2947408,37.33806112,30
곤지암리조트 L빌리지,10,10,127.2964629,37.33749818,20
곤지암리조트 게임 캠프,5,5,127.2940951,37.33798434,10
곤지암리조트 곤지암루지360,8,8,127.2849244,37.33357642,16
곤지암리조트 빌리지센터,3,3,127.2944491,37.33733742,6
곤지암리조트 스키장,3,4,127.2935267,37.33692164,7
곤지암리조트 스파라스파,13,13,127.2952878,37.33709746,26
곤지암리조트 야외 셀프BBQ 바베큐장,4,3,127.2940951,37.33798434,7
곤지암리조트 카페라운지,5,5,127.2940872,37.33828981,10
곤지암역 경강선,4,4,127.3462513,37.35053954,8
골드리버호텔,4,2,126.8769805,37.47833228,6
골드식당 본점,3,3,126.9262797,37.56384244,6
골드펫리조트,3,2,127.1373963,37.21971495,5
골드헤겔,10,8,127.0636427,37.1982929,18
골든리버호텔,7,6,126.8828259,37.44765338,13
골든벨함흥면옥,8,9,127.2163907,37.28728776,17
골든타이,4,4,127.1194506,37.51469695,8
골든타임이스케이프,4,4,127.0745128,37.25265579,8
골든튤립에버 용인호텔,46,43,127.2167441,37.28705825,89
골든트리,20,21,127.5390494,37.75514006,41
골든포크,5,5,126.9900394,37.56526699,10
골든호텔,3,3,126.7086795,37.46556365,6
골목오리집,2,3,126.8931226,37.51337551,5
골목집소머리국밥,4,4,127.3399526,37.35033346,8
골목횟집,5,5,126.6413417,37.38535049,10
골프존파크 부곡더조은골프점,3,4,126.85885,37.32696223,7
곰이빠진탕,4,4,127.2402362,37.95442339,8
곰팡이마트,5,5,126.9199635,37.56631247,10
곱 마포점,10,10,126.949376,37.54102872,20
곱분이곱창 광명역점,5,5,126.8830311,37.42041768,10
곱분이곱창 동덕여대점,5,5,127.0426676,37.6034496,10
곳간,5,5,126.9254167,37.56657733,10
공간갑,5,1,126.9902884,37.56548325,6
공간과몰입,5,5,127.0055972,37.58054815,10
공간와디즈,9,9,127.0505248,37.54493009,18
공감팩토리,4,5,126.3360205,36.49718208,9
공군호텔,12,11,126.9236361,37.5100979,23
공덕역 5호선,5,5,126.9514512,37.54454169,10
공덕역 6호선,10,10,126.9518954,37.54353005,20
공덕역 공항철도,5,5,126.9526023,37.54231489,10
공도시외버스정류장,6,6,127.1665373,36.99880318,12
공룡알화석산지 방문자센터,3,5,126.7470582,37.26235205,8
공룡알화석산지(화성),5,5,126.3577307,33.36627759,10
공릉동 멸치국수,4,5,127.1160724,37.52740085,9
공릉동닭 한마리 호평점,4,4,127.2408266,37.65470245,8
공릉동도깨비시장,3,3,127.0771315,37.62285161,6
공릉동원조멸치국수 경희대점,1,3,127.0527652,37.59285306,4
공릉동원조멸치국수 원남점,5,5,126.9969661,37.57580001,10
공릉천,4,3,126.7614898,37.7495472,7
공미학,4,4,127.0124493,37.48865455,8
공미학 마포홍대점,4,5,126.9238695,37.55643832,9
공사중,3,3,126.9002312,37.48385036,6
공산성,5,5,127.1262966,36.46324084,10
공샤브,5,5,126.9798963,37.57082664,10
공자상,3,3,126.6203431,37.47452473,6
공작아파트,5,5,126.929837,37.52651802,10
공주왕축밤영농조합법인,4,4,127.1228341,36.46357068,8
공주종합버스터미널,4,4,127.134758,36.46857368,8
공지천유원지,3,4,127.7115795,37.87466959,7
공차 건대로데오점,4,4,127.0686321,37.53983932,8
공차 고속터미널점,3,3,127.0069895,37.506021,6
공차 까치산역점,5,5,126.8472084,37.53036479,10
공차 대학로점,3,3,127.001182,37.58380267,6
공차 롯데시네마인천아시아드점,4,4,126.6675633,37.54640559,8
공차 롯데청량리점,5,5,127.0476723,37.58081797,10
공차 보라매점,5,5,126.9254019,37.4917122,10
공차 부평문화의거리점,4,5,126.7243144,37.49397926,9
공차 사당본점,3,3,126.9813871,37.47496922,6
공차 서울역점,9,10,126.9707484,37.55465725,19
공차 성대점,4,4,126.9721507,37.29813074,8
공차 양평점,5,4,127.4917893,37.4903896,9
공차 영등포구청점,5,5,126.8970608,37.52669943,10
공차 오산시청점,3,3,127.0753145,37.14857661,6
공차 용인상현역점,4,4,127.0696789,37.29735664,8
공차 인천주안점,3,3,126.681807,37.46372116,6
공차 파르나스몰점,3,3,127.0608511,37.5091322,6
공차 파주야당점,4,4,126.7601752,37.71317423,8
공차 홍대입구역점,4,4,126.9241838,37.55682776,8
공차 화성시청점,3,3,126.8268216,37.20016483,6
공평동꼼장어 을지로점,5,5,126.990157,37.56670138,10
공화춘 차이나타운1호점,5,5,126.619588,37.47539087,10
공희네우렁쌈밥 본점,4,4,126.7360304,37.39981065,8
과천 서울대공원,5,5,126.6701521,33.54075953,10
과천 서울랜드,5,5,126.6792945,33.43583724,10
과천경마공원,4,5,126.5545223,33.24721232,9
과천대공원 호수,5,5,127.0134231,37.43299893,10
과천서울대공원 스카이리프트중간도착지,4,4,127.0174312,37.42976195,8
과천서울대공원 스카이리프트출발지,4,4,127.0094502,37.43168743,8
과천서울대공원자연캠핑장 주차장,3,3,127.0221485,37.43076129,6
과천시민회관,14,14,126.9890317,37.4284076,28
과천시민회관 야외공연장,4,4,126.9890814,37.42842202,8
과천역 4호선,4,4,126.9966171,37.4328753,8
과천자이아파트,4,4,126.9986668,37.42826935,8
과천중앙공원,12,12,126.9950106,37.4308876,24
과천청사 시민광장,13,13,126.9857425,37.42417787,26
과천해신탕,2,3,126.9932572,37.42872508,5
과천향교,3,3,126.9876118,37.43374148,6
과학동광문구,3,4,127.0167931,37.28402257,7
관고전통시장,12,13,127.4405732,37.28075667,25
관곡지,3,3,126.804537,37.40233685,6
관동오리진,10,11,126.6206856,37.47384467,21
관모봉,7,8,126.9184601,37.3771083,15
관세인재개발원,4,3,127.2951502,36.76640256,7
관악관,5,5,126.9491209,37.40337046,10
관악부영아파트,3,3,126.9453276,37.39644622,6
관악산,8,7,126.9638968,37.44446951,15
관악산둘레길 사색의숲길3구간,5,5,126.925688,37.47116488,10
관악산둘레길 애국의숲길1구간,4,4,126.9593259,37.47132901,8
관악산산림욕장,4,4,126.9558413,37.41442868,8
관악산역 신림선,10,10,126.9450995,37.46908605,20
관악역 1호선,3,3,126.9085,37.41956796,6
광교산,13,13,127.034428,37.34492778,26
광교산제빵소,4,4,126.9997405,37.31306418,8
광교시티아이,3,3,127.0417995,37.3014803,6
광교역사공원,3,3,127.0521245,37.29669169,6
광교저수지,8,8,127.0285381,37.30618945,16
광교중앙역 신분당선,7,7,127.0517263,37.2883843,14
광교중흥S클래스아파트,4,4,127.0578813,37.28231115,8
광교카페거리,10,10,127.0525111,37.29377489,20
광교호반마을22단지아파트,4,4,127.0697903,37.27997014,8
광교호수공원,110,109,127.0669306,37.28431303,219
광교호수공원 원천습지,4,4,127.0626718,37.28546325,8
광교호수공원 프라이부르크전망대,4,5,127.0659819,37.2806472,9
광덕안정한의원 구로디지털점,4,4,126.9022521,37.4844395,8
광릉,19,21,127.1765011,37.75099701,40
광릉돌솥밥,3,4,127.2086456,37.74960385,7
광릉빵명장,3,3,127.2038789,37.74759763,6
광릉수목원길,9,9,127.1696415,37.76231601,18
광릉숲길,14,13,127.1876388,37.74810933,27
광릉진빵만두,5,5,126.6267206,37.47148884,10
광릉한옥집,2,2,127.1993009,37.74306099,4
광림교회,3,3,127.0255982,37.52439531,6
광림아트센터 BBCH홀,7,10,127.0254986,37.52404214,17
광명 가구거리,4,4,126.8564943,37.48556049,8
광명동굴,65,69,126.8657359,37.42646315,134
광명동굴 푸드코트,5,5,126.8644482,37.4251755,10
광명사거리역 7호선,3,3,126.8548737,37.47929831,6
광명새빛공원,13,12,126.8884036,37.4160169,25
광명스피돔 경륜본장,5,5,126.8451924,37.46678542,10
광명시민회관,4,3,126.8637596,37.4770888,7
광명시소하도서관,5,5,126.8880322,37.44544554,10
광명시자원회수시설,7,6,126.8639023,37.42577809,13
광명업사이클아트센터,15,17,126.8634004,37.4247125,32
광명역,71,71,126.884804,37.41645134,142
광명역 1호선,17,17,126.8849617,37.41673622,34
광명역 A주차장,3,3,126.883893,37.41825609,6
광명전통시장,41,42,126.8563564,37.47962809,83
광명햇살광장,5,5,126.8703928,37.49070509,10
광명홍두깨칼국수,4,4,127.0704466,37.15283531,8
광복낚시,5,5,126.6125684,37.45396376,10
광야아트센터,4,4,127.0396438,37.52389047,8
광양불고기집,4,4,127.0721724,38.01722522,8
광어부인정때문에,5,5,126.5965242,37.47098684,10
광장동수제모찌 오산세교점,4,4,127.0421018,37.18602206,8
광장스넥,4,4,127.00163,37.57045713,8
광장시장,208,207,127.0296863,37.57947253,415
광장시장 수입구제상가,5,5,126.9987186,37.56990212,10
광장시장 전골목,29,30,127.0006339,37.57056166,59
광장시장찹쌀꽈배기,9,9,127.0003373,37.57070312,18
광장시장통큰누이네육회빈대떡,4,4,127.0011772,37.57043912,8
광적농협하나로마트,5,5,126.9838436,37.82621062,10
광주공항,14,14,126.810978,35.14017939,28
광주삼리구석기유적,1,1,127.3326768,37.35072626,2
광주성당,4,3,127.2541936,37.41184084,7
광주송정역,76,75,126.790805,35.13766751,151
광주육전,5,5,127.0243125,37.50854152,10
광주향교,9,9,127.0537452,36.33376614,18
광혜원시외버스터미널,4,4,127.4438407,36.99325863,8
광화문,52,53,126.976861,37.57596897,105
광화문광장,271,277,126.9769164,37.57260286,548
광화문광장 세종대왕동상,14,14,126.9769072,37.57295245,28
광화문광장 이순신 장군 동상,15,15,126.9769984,37.5709955,30
광화문광장 일대,5,5,126.9767435,37.5716352,10
광화문광장 해치마당,4,4,126.9769347,37.57199379,8
광화문광장지하,5,5,126.9767435,37.5716352,10
광화문국밥 본점,15,15,126.9753917,37.56895893,30
광화문미진 본점,3,4,126.9799234,37.57084467,7
광화문역 5호선,14,14,126.9764243,37.57164861,28
광희동중앙아시아촌,10,10,127.005673,37.56536098,20
괘법르네시떼역 부산김해경전철,4,4,128.9776582,35.16327219,8
괴르츠,4,4,126.9258412,37.54487437,8
괴산휴게소 양평방향,10,9,127.960181,36.8317472,19
괴흐엉관,4,4,126.7736685,37.76250908,8
교감막국수,4,4,127.226153,37.59473309,8
교다이야,3,3,126.9132196,37.54684796,6
교대가맥 교대본점,5,5,127.0135352,37.49123132,10
교대역 2호선,5,5,127.0143838,37.4939,10
교대역 3호선,6,6,127.013868,37.49274317,12
교대이층집 사당점,4,4,126.9834984,37.47763472,8
교동대룡시장,3,3,126.2810514,37.78049119,6
교동면옥,5,5,127.1220423,37.30251321,10
교동식당,3,3,127.5136622,37.83051898,6
교동짬뽕 남양점,4,4,126.8442613,37.22286665,8
교동짬뽕 수원역점,4,3,127.0010034,37.26781404,7
교보문고 강남점,9,9,127.024121,37.50401131,18
교보문고 건대 바로드림센터,5,5,127.0711478,37.53907378,10
교보문고 광화문점,83,85,126.9779086,37.57079746,168
교보문고 분당점,5,5,127.1226249,37.38341244,10
교보문고 인천점,4,4,126.7009572,37.44615463,8
교보문고 판교점,5,5,127.1120475,37.39279718,10
교보문고 평촌점,5,5,126.9504803,37.39022693,10
교보문고 합정점,9,9,126.9122834,37.55103241,18
교복몰 용인점,14,15,127.217342,37.28673368,29
교복몰 잠실점,4,4,127.0936503,37.51151265,8
교촌치킨 방이2호점,3,3,127.109679,37.51478211,6
교촌치킨 신용산역점,4,4,126.9700598,37.53040577,8
교촌치킨 약수점,5,5,127.0111545,37.55618844,10
교하제면소,5,9,126.7069133,37.77932708,14
구구알칼리치킨,2,2,126.9910941,37.56719881,4
구도로통닭 부평점,3,3,126.7262678,37.49292061,6
구둔역 (폐역),14,14,127.6884219,37.43737408,28
구로디지털단지역 2호선,9,9,126.9014731,37.48526058,18
구로역 1호선,11,11,126.8823081,37.50334156,22
구루몽,4,4,127.1558518,37.6058074,8
구르메 수택점,4,4,127.1377309,37.59977168,8
구르미한복,10,10,126.9740647,37.57649997,20
구름빵카페,5,5,127.0105584,37.66253047,10
구름산,4,4,126.8661852,37.44064385,8
구름산추어탕,5,5,126.8716849,37.45715651,10
구리 농수산물도매시장 수산물동,7,8,127.145817,37.6099927,15
구리남양주TG,5,4,127.1570026,37.58970968,9
구리시곤충생태관,5,5,127.1611093,37.59024114,10
구리시청,3,3,127.1296396,37.59435238,6
구리역 경의중앙선,4,3,127.143351,37.60327074,7
구리전통시장,13,13,127.1396615,37.59965318,26
구리타워,4,4,127.1600715,37.58889827,8
구리한강시민공원,14,14,127.1425825,37.57562564,28
구리휴게소 일산방향,19,16,127.1391615,37.62792318,35
구미공원,4,4,127.1176581,37.34092868,8
구미역,16,16,128.3310162,36.12827222,32
구미종합터미널,6,6,128.3520881,36.12270145,12
구벼울,7,8,127.1635575,37.60583954,15
구봉도,4,4,126.5446871,37.28296428,8
구봉솔숲해수욕장,14,13,126.5534884,37.28198865,27
구봉양식장,15,15,126.5598088,37.27481127,30
구산성지,3,3,127.18931,37.57261911,6
구삼부대찌개,5,5,127.1317226,37.52336236,10
구성각칼국수,4,4,127.5074374,37.83317673,8
구스따레 일 젤라또,4,4,127.1076009,37.51068355,8
구스아일랜드 브루하우스,2,3,127.031997,37.49333431,5
구시야끼에독코,3,2,127.0338226,37.49433572,5
구욱희씨,3,3,127.0418695,37.54711029,6
구월도매시장,4,4,126.7063128,37.44351908,8
구월동로데오거리,4,5,126.7020577,37.44507619,9
구월로데오광장,4,4,126.7020248,37.44480581,8
구의3동주민센터,4,4,127.0919613,37.53798181,8
구의역 2호선,4,2,127.0861808,37.53717527,6
구이구이 2호점,1,1,126.9182758,37.52593755,2
구일가든,3,3,127.3481702,37.34860932,6
구일본우선주식회사인천지점,4,4,126.6196481,37.47334038,8
구일역 1호선,3,3,126.8696911,37.49625452,6
구장사거리,3,4,126.8941749,37.16887305,7
구좌리 얼크니손칼국수 화담숲점,16,15,127.3320127,37.34240986,31
구쯔커피 평내점,1,1,127.2313277,37.64371508,2
구캔갤러리,3,3,128.9145257,37.79285332,6
구테로이테,3,4,127.0396303,37.51769518,7
구테로이테 경복궁점,5,5,126.9733179,37.57536455,10
구포역,37,36,128.997114,35.20548095,73
구포역 주차장,6,6,128.9976959,35.20592914,12
구하우스미술관,15,15,127.094852,36.15549203,30
구황작물,5,5,126.9053385,37.55272453,10
국고집,5,5,127.0359784,37.48595932,10
국군복지단 충일마트,5,5,127.1946094,37.61501291,10
국대오리 고촌점,4,4,126.7842006,37.60272443,8
국립4.19민주묘지,5,5,127.0076555,37.64857628,10
국립6.25전쟁납북자기념관,3,4,126.7435201,37.8889773,7
국립고궁박물관,87,88,126.9748254,37.57662087,175
국립공원공단 북한산생태탐방원,10,10,127.0347195,37.68733159,20
"국립공원공단 북한산생태탐방원, 광륜사",2,2,127.0347195,37.68733159,4
국립과천과학관,33,34,127.0058182,37.43803172,67
국립과천과학관 중앙주차장,5,5,127.0071552,37.44062207,10
국립과천과학관 푸드코트,4,4,127.0245221,37.42299225,8
국립국악원,5,5,127.0088286,37.47792477,10
국립극단 명동예술극장,5,5,126.9842128,37.56400856,10
국립대구박물관,4,5,128.6380002,35.84574671,9
국립대전현충원,5,5,127.2959333,36.3702359,10
국립민속박물관,65,65,126.9790329,37.5817087,130
국립민속박물관 파주,20,21,127.067372,37.75719482,41
국립생물자원관,4,4,126.6380214,37.56595496,8
국립서울현충원,14,15,126.978409,37.49982392,29
국립수목원,37,38,127.166094,37.75525028,75
국립수목원 국립산림박물관,5,5,127.1647391,37.75576213,10
국립수목원 난대식물원,4,4,127.1661007,37.7562089,8
국립수목원 방문자센터,4,4,127.168696,37.75172921,8
국립수목원 산림헌장비,3,2,127.1658479,37.75481456,5
국립수목원 숲생태관찰로,5,5,127.1660897,37.75534759,10
국립수목원 숲의명예전당,3,2,127.1654927,37.75431052,5
국립수목원 열대식물자원연구센터,5,5,127.1634631,37.75401063,10
국립아세안자연휴양림 브루나이,3,3,126.9422431,37.7737151,6
국립양평치유의숲,5,5,127.7181292,37.46117191,10
국립운악산자연휴양림,5,5,127.3064374,37.88159625,10
국립유명산자연휴양림,42,43,127.4910639,37.59290086,85
국립유명산자연휴양림 산림문화휴양관,8,8,127.4885808,37.59051915,16
국립유명산자연휴양림 산림복합체험센터,5,5,127.4922523,37.59253214,10
국립유명산자연휴양림 자생식물원,14,14,127.4933906,37.59258415,28
국립이천호국원,3,3,127.4880692,37.12637315,6
국립정동극장,5,5,126.9727758,37.56585893,10
국립정신건강센터,3,3,127.0858056,37.56513532,6
국립중앙박물관,198,207,126.9779564,37.47544261,405
국립중앙박물관 극장 용,4,4,126.9789495,37.52430971,8
국립중앙박물관 기획전시관,5,5,126.9790129,37.52387364,10
국립중앙박물관 도서관,5,5,126.9789948,37.5241151,10
국립중앙박물관 어린이박물관,7,7,126.9791123,37.52435299,14
국립한글박물관,18,18,126.9809775,37.52118538,36
국립항공박물관,5,5,126.8088693,37.55686859,10
국립현대미술관 과천,1,1,126.5283034,33.51278396,2
국립현대미술관 과천관,77,79,127.0200799,37.43128966,156
국립현대미술관 덕수궁관,24,25,126.9737401,37.56593843,49
국립현대미술관 서울관,199,205,126.980098,37.57862749,404
국립현대미술관 서울관 아트샵,5,5,126.980098,37.57862749,10
국립현대미술관 야외조각장,5,5,127.0185475,37.43007173,10
국물없는우동,14,14,126.6857899,37.79211852,28
국민갈비,3,3,127.0183434,37.27870621,6
국민대학교,6,6,126.9969692,37.6107639,12
국민맥주 북창점,3,3,126.9775192,37.56320199,6
국밥대장 삼각지점,4,4,126.9738711,37.53428369,8
국밥쟁이 김포점,2,2,126.6541596,37.65161586,4
국수리국수집,10,10,127.4039269,37.51320533,20
국수리순두부,3,3,127.3997543,37.5155405,6
국수역 경의중앙선,4,4,127.3993098,37.51618712,8
국일관 주차장,3,3,126.9900162,37.56974674,6
국제갤러리,4,3,126.9807813,37.58035211,7
국제유선바다낚시,4,5,126.6124999,37.45388425,9
국토지리정보원 지도박물관,2,5,127.0551547,37.27613943,7
국화축제,4,4,126.9296698,37.49220218,8
국회의사당,10,10,126.9141624,37.53190827,20
군산고속버스터미널,4,4,126.7244397,35.97819947,8
군산시외버스터미널,5,3,126.7244468,35.97741721,8
군산역,5,3,126.7597894,35.99925254,8
군위영천휴게소 영천방향,3,3,128.7084909,36.0709483,6
군위휴게소,5,5,128.5711432,36.25876546,10
군자농협 하나로마트 대부점,4,4,126.5889516,37.240983,8
군포문화예술회관,4,4,126.9272181,37.36662248,8
군포시민체육광장,5,5,126.9368467,37.35420464,10
굴다리숯불구이본가,4,4,126.9378815,37.34218186,8
굴업리포차,4,3,127.6720018,37.616572,7
굴토리,2,2,126.7472776,37.67117269,4
굴포천,7,8,126.7244314,37.50891456,15
굴포천역 7호선,5,5,126.7313476,37.50704649,10
굴포천자전거길,5,4,126.7589294,37.53794815,9
굽네치킨 송도3동점,4,4,126.6539084,37.37818879,8
굽네치킨 수택3동점,4,4,127.1428437,37.59147919,8
굿맘할매순대국&양선지해장국 부평역점,5,5,126.7245974,37.4908264,10
굿빈스커피 권선중앙점,3,4,127.0219102,37.26005405,7
굿윌스토어 본점,3,4,127.1277546,37.48114201,7
궁게스트하우스,5,3,126.9914351,37.57438157,8
궁뜰38카페피자,4,4,127.3359163,37.3396435,8
궁평식당,4,4,127.3211063,37.3380826,8
궁평의하루,3,2,126.6827207,37.11692087,5
궁평항,27,28,126.6461017,36.51458374,55
궁평항 주차장,1,1,126.68181,37.11649132,2
궁평항수산물직판장,11,11,126.6818794,37.11549674,22
궁평항횟집,3,3,126.6840654,37.11688301,6
권가네갈비 동탄점,2,2,127.1172957,37.1539876,4
권오길손국수 본점,5,5,126.6865983,37.61543656,10
권율장군묘,3,4,126.9497328,37.73388471,7
궤도,9,10,126.9690381,37.57708441,19
궤도연희,3,4,126.9309315,37.56518053,7
귤현프라자,5,5,126.7408136,37.5728648,10
그날그한복,5,5,126.9806733,37.57750495,10
그남자의밥상,5,5,127.4565101,37.25470145,10
그냥 꽃,4,4,127.170524,37.55797233,8
그냥찌개집 교대본점,5,5,127.0134336,37.4921918,10
그대가오면,5,5,126.7306997,37.3770911,10
그라운드시소 명동,20,22,126.9816298,37.5642028,42
그라운드시소 서촌,32,34,126.9729163,37.57783859,66
그라운드시소 성수,38,40,127.0652799,37.5467681,78
그랑셰프,2,2,127.5899036,37.82213709,4
그랑핸드 남산,5,5,126.9835551,37.54892217,10
그랑핸드 도산,5,5,127.0349589,37.52559394,10
그랑핸드 북촌,15,15,126.9839803,37.58182661,30
그랑핸드 서촌,9,9,126.9730229,37.57722954,18
그랑핸드 소격,12,14,126.9820338,37.57865483,26
그래비테이트,9,9,127.014479,37.28332007,18
그래비티 서울 판교 오토그래프컬렉션,25,25,127.1100947,37.39339369,50
그랜드머큐어앰버서더,3,3,126.9625061,37.53190108,6
그랜드빌라,3,3,126.9205677,37.56012753,6
그랜드워커힐서울,77,79,127.1110034,37.55519795,156
그랜드워커힐서울 더글라스하우스,8,8,127.109264,37.55597172,16
그랜드워커힐서울 더뷔페,23,24,127.1108868,37.55515121,47
그랜드워커힐서울 르파사쥬,9,10,127.110828,37.55521253,19
그랜드워커힐서울 수영장,4,4,126.9063665,33.47866074,8
그랜드워커힐서울 워커힐씨어터,3,5,127.1103532,37.55557157,8
그랜드워커힐서울 컨벤션센터,3,2,127.1108777,37.55510616,5
그랜드인터컨티넨탈 서울파르나스,28,27,127.0608271,37.50929061,55
그랜드인터컨티넨탈 서울파르나스 로비라운지&바,4,4,127.0607932,37.5092636,8
그랜드제빵소,3,3,127.2782144,36.46742793,6
그랜드젬모텔,7,6,127.0990538,37.59985643,13
그랜드팰리스호텔 인천,15,14,126.7092102,37.40203992,29
그랜드하얏트서울,42,43,126.9970808,37.53944477,85
그랜드힐컨벤션,1,2,127.0667169,37.50605282,3
그레이스그래니,5,5,127.0597879,37.16924221,10
그레이스병원,5,5,126.785076,37.64479124,10
그레이츠 판교,5,5,127.1120271,37.39427127,10
그레이캐슬펜션,4,4,126.9512591,37.7418229,8
그레이트커피,4,4,127.0396654,37.54766607,8
그레이트후카바 홍대2호점,3,4,126.921916,37.55005438,7
그로운 베이커리,3,4,126.9259722,37.68676568,7
그리고케이크,4,4,126.6827927,37.64848523,8
그리니쉬,4,3,126.7335999,37.40238571,7
그리운보리밥,5,5,128.5937713,38.21403094,10
그리츠,9,9,126.9172787,37.52738026,18
그리핑,4,4,127.0122838,37.28523142,8
그린냅,5,5,126.9706522,37.57780561,10
그린디자인웍스 공장,4,4,126.9255585,37.5697309,8
그린브라우니 세종홈플러스점,3,3,127.2587665,36.50736863,6
그린존 롯데렌터카 관악영업소(서울대입구역 3번출구),5,5,126.952243,37.48104285,10
그린하우스,4,4,126.9938629,37.5609248,8
그린히어로 소셜키친,5,5,126.4892234,33.48846638,10
그린힐펜션,10,10,127.3454352,38.05255337,20
그릴1492 본점,4,4,127.0125639,37.56512619,8
그릴데미그라스,3,3,126.991147,37.56001877,6
그릴도하 한남점,2,2,127.001842,37.53833115,4
그림나베 교대역점,3,3,127.0143298,37.49513979,6
그림나베 남부터미널점,4,4,127.0162479,37.48581592,8
그믐달,5,5,126.6734086,37.64369525,10
그믐달 셀프스튜디오 수원행궁점,8,8,127.0149632,37.28557711,16
그믐족발 성수점,4,4,127.0534674,37.5424997,8
그찻집,3,3,127.289179,37.34138342,6
근대골목도나스 용산역점,5,5,126.9645437,37.52952847,10
근종이네,4,4,127.0300153,37.26527471,8
근현대사기념관,3,4,127.0027873,37.64344089,7
글래드 마포,55,55,126.9513448,37.54276668,110
글래드 여의도,39,40,126.9172922,37.52740301,79
글래드강남코엑스센터,8,7,127.0646497,37.5088543,15
글램독펜션,9,9,127.5079905,37.85436186,18
글램라운지,4,4,126.9937862,37.53509821,8
글램퍼스 양평점,5,5,127.6819564,37.57934243,10
글램핑사그막끝마을펜션,5,5,127.4906984,37.82362734,10
글램핑앤카라반,4,4,127.6776924,37.58602341,8
글레이셔박,7,7,127.0397196,37.54745702,14
글로브비스트로,4,4,127.0608542,37.50922392,8
글로어 부평점,4,3,126.7249883,37.49399885,7
글로우그라피,5,5,127.0363732,37.51678802,10
글로우오브선셋,4,4,126.7008847,37.76860671,8
글린공원,10,10,126.6492289,37.64997954,20
금강산매운갈비찜,17,17,127.3145153,37.99597034,34
금강산숯불닭갈비,1,1,127.3802925,37.77208105,2
금강휴게소 양방향,5,5,127.67213,36.27895018,10
금계숯불닭갈비,4,4,127.4873235,37.67354686,8
금광저수지,5,5,127.3369,36.99714525,10
금국,3,3,126.9730264,37.56140806,6
금금,4,4,127.0566563,37.53982765,8
금나래중앙공원,4,4,126.8950373,37.45773278,8
금남주유소,3,3,127.3574334,37.63941898,6
금동 카스테라,5,5,127.4067313,37.60136673,10
금돼지,5,5,126.9780402,37.56193799,10
금별맥주 공덕역점,3,3,126.9517624,37.54448776,6
금별맥주 오산운암점,5,5,127.0750674,37.14692332,10
금복주류 강남역점,4,4,127.0250653,37.50024851,8
금빛수로보트하우스,13,14,126.6738651,37.64216844,27
금사농협하나로마트,2,3,127.5350921,37.40090199,5
금산,9,9,126.6034995,37.45635559,18
금산인삼랜드휴게소 대전방향,4,4,127.4976753,36.15489663,8
금상고로케 서촌마을점,5,5,126.9696507,37.57955689,10
금섬침대 김포검단점,4,4,126.6839407,37.64122101,8
금성관,5,5,126.716497,35.0333653,10
금성양곱창,5,5,127.1356228,37.53444747,10
금양곱창,2,2,126.7714809,37.60126251,4
금옥당 인사점,4,4,126.9841053,37.5744619,8
금왕휴게소주유소 제천방향,3,3,127.5915818,36.97032447,6
금요일오후,3,3,127.2530329,37.33501308,6
금융감독원,6,8,126.9213333,37.52309246,14
금은모래캠핑장,5,5,127.665037,37.29376076,10
금잔디우렁이쌈밥,3,4,127.11071,38.03130735,7
금정스크린골프,5,5,126.9439565,37.37381457,10
금정역 1호선,8,6,126.94327,37.37233746,14
금천구청역 1호선,8,7,126.8936086,37.45619437,15
금촌통일시장,4,5,126.773609,37.76269276,9
금촌통일시장 1공영주차장,5,5,126.7732034,37.76321184,10
금화마을5단지주공그린빌아파트,10,10,127.1122162,37.26640029,20
기계회관 버스정류장,5,5,126.922634,37.529098,10
기노스코 송도점,4,4,126.6316192,37.39535974,8
기린,5,5,127.0774983,37.62806448,10
기립커피로스터스,4,4,126.7189303,37.72492277,8
기산저수지,10,10,126.954282,37.7779943,20
기생충 포토존,2,3,126.964098,37.59327385,5
기억저장소,5,5,126.9202816,37.55885423,10
기와집순두부,2,2,127.2730962,37.51203777,4
기와집순두부 조안본점,22,24,127.3024207,37.53732404,46
기요항,5,5,126.7504067,37.6689134,10
기형도문학관,7,8,126.8815349,37.42642057,15
기흥역 수인분당선,10,10,127.1159551,37.2754972,20
기흥역시외버스정류소,5,5,127.1161684,37.27489149,10
기흥호수공원,5,5,127.0957046,37.25408853,10
기흥휴게소,3,3,127.1045053,37.236381,6
기흥휴게소 부산방향,21,21,127.1045697,37.23501853,42
긱스타 PC방,3,3,126.9958123,37.56132818,6
긱스타PC방,4,4,127.039967,37.49809314,8
긱스타PC카페,3,3,127.008186,37.56775027,6
긱스타PC카페 상암점,2,2,126.894979,37.5785265,4
긴자바이린 종로점,5,5,126.9804831,37.57762385,10
길거리 토스트,5,3,129.282066,35.83625257,8
길버트버거앤프라이즈 이태원점,3,3,126.9889257,37.53454284,6
길상사,6,7,126.9944015,37.59896083,13
길음역 4호선,5,5,127.0250602,37.60339478,10
길조,4,5,127.4733961,37.49369752,9
길조호텔,5,5,127.4734597,37.49357203,10
김가네 동대문공원점,5,5,127.0065513,37.56517803,10
김가네 무교점,9,9,126.9787563,37.56715399,18
김가네 종로3가점,3,3,126.9889655,37.57175406,6
김가네.스타벅스,4,4,127.7359395,34.74078233,8
김가네잣두부,5,5,127.345539,37.80103677,10
김경자원조 손칼국수 보쌈,3,4,126.2547263,33.40330462,7
김경진순녹두빈대떡 2호점,5,5,126.9232996,37.41886488,10
김광석길 공영주차장,4,4,128.6064066,35.85930118,8
김교수김밥,4,4,126.9294017,37.61140234,8
김명자굴국밥 청진점,5,5,126.9807151,37.57379286,10
김밥세상,4,4,126.7493906,37.5076655,8
김밥천국,4,4,127.2038396,37.23549838,8
김밥천국 구월점,2,2,126.7111031,37.45262029,4
김밥천국 망원점,4,4,126.9038009,37.56031599,8
김밥천국 상계점,3,3,127.0737205,37.66039601,6
김밥천국 잠원점,3,3,127.0055328,37.50673468,6
김밥천국 초량점,3,3,129.0401268,35.11671971,6
김밥풍경,5,5,127.3880376,36.36914318,10
김삼보 여의도점,3,4,126.919172,37.5299242,7
김삼보 종로점,5,5,126.9801125,37.57081947,10
김삼보김치찌개 신촌점,5,5,126.9396917,37.55889548,10
김삿갓밥집,10,10,127.3614359,37.66435397,20
김셰프차이나웍,4,4,126.8467709,37.53405112,8
김억삼포장마차,4,4,126.9222908,37.55090517,8
김영모과자점 강남구청점,3,3,127.0426524,37.51514249,6
김영모과자점 서초동성당점,5,5,127.0213179,37.49377641,10
김영순김밥,3,3,126.7713201,37.65965229,6
김영화부대찌개,4,4,126.9164883,37.13040122,8
김우정초당짬뽕순두부 본점,5,5,128.9165171,37.79158859,10
김유신장군상,2,2,126.978171,37.55579411,4
김유정역 (폐역),2,3,127.7164643,37.81945947,5
김종구부산어묵,5,5,126.6462046,37.37894988,10
김종구부산어묵 인천원당점,5,4,126.6967545,37.59398897,9
김준호의대단한커피 하남미사점,3,3,127.1921735,37.56367031,6
김중업건축박물관,4,4,129.2096454,35.83933482,8
김천역,3,3,128.1147031,36.12346257,6
김칼국수,5,5,127.0120442,37.57159178,10
김태완스시 마포본점,5,5,126.9478177,37.53968555,10
김포 라베니체 주변,3,3,126.6772804,37.6433291,6
김포1번가축산물도매시장,5,5,126.5877278,37.65036717,10
김포공항,10,10,126.8002482,37.562406,20
김포공항역 9호선,10,10,126.8019136,37.56196757,20
김포공항역 김포골드라인,4,3,126.8019919,37.5623299,7
김포국제공항 국내선,371,366,126.8028696,37.5589565,737
김포국제공항 국내선 출발층,4,3,126.8034873,37.55920595,7
김포금쌀밥집 지미재,2,3,126.6429021,37.64839285,5
김포마스터비즈파크,4,3,126.6809027,37.63785938,7
김포성당,5,4,126.7082735,37.62967002,9
김포아트빌리지,17,15,126.6958908,37.64649432,32
김포아트빌리지 아트센터,4,4,126.696285,37.64653498,8
김포에코센터,3,3,126.6993519,37.6547814,6
김포조각공원,4,4,126.5540237,37.72106898,8
김포캠핑파크,10,10,126.5586319,37.74728274,20
김포프리미엄아울렛,5,5,126.7851086,37.5979056,10
김포한강야생조류생태공원,3,3,126.6888335,37.65742102,6
김포한옥마을,25,25,126.6954965,37.6453833,50
김포함상공원,5,7,126.5392728,37.64061681,12
김해공항,4,3,126.492769,33.50707896,7
김해국제공항,108,107,128.9467287,35.1731997,215
김해국제공항 국내선청사,92,88,128.9488189,35.17027509,180
까끼토끼놀이터,5,5,127.4973214,37.8104349,10
까르띠에메종 청담,5,5,127.0449399,37.52699884,10
까르보마마,3,2,127.0400534,37.47116704,5
까몬 광교앨리웨이점,5,5,127.0612623,37.27308731,10
까몬 행궁본점,23,24,127.0163077,37.28706275,47
까사노블풀빌라,7,7,127.5093357,37.79731437,14
까치네떡볶이,4,4,126.7019359,37.44443256,8
까치울마을,4,4,126.8106962,37.50795715,8
까치울역 7호선,9,8,126.8113396,37.50622735,17
까페26애비뉴,6,6,126.6954893,37.71480523,12
까폼 본점,4,4,127.0379926,37.52485689,8
깍뚝,4,4,127.071828,37.54745176,8
깔깔거리,4,4,126.9010862,37.48366367,8
깔리,4,4,126.9992664,37.58247551,8
깜온,4,4,126.9736685,37.57637374,8
깡통만두,12,13,126.9860845,37.57816524,25
꼬꼬아찌숯불치킨 인계나혜석거리점,4,5,127.0337307,37.26436546,9
꼬꼬오리주물럭,14,13,126.6103491,37.67663453,27
꼬닐리오베이커리카페,3,3,126.6846757,37.79009469,6
꼬르꼬바두,5,5,126.9900503,37.56887097,10
꼬마연못,5,5,127.1658169,37.78615283,10
꼬막사랑,3,3,126.6893366,37.34185876,6
꼬모,5,5,126.5283034,33.51278396,10
꼬알라파이,10,10,126.6261759,37.47213494,20
꼴라보하우스 도산,7,7,127.0352282,37.52573532,14
꼼빠도르,5,5,127.0164493,37.27945615,10
꽁당보리밥 평택점,4,4,127.1141127,36.98918482,8
꽁시면관 본점,3,4,126.9832151,37.56138292,7
꽁티드툴레아 도산점,13,13,127.0368888,37.52556362,26
꽃꽃한당신,3,4,127.0896286,37.18327806,7
꽃이피움,4,4,126.983212,37.575024,8
꽈페 망원점,4,4,126.9052684,37.55440393,8
꽈페 연남점,1,1,126.925729,37.56218787,2
꽈페 홍대점,3,3,126.9225085,37.55490574,6
꾸띠자르당,4,4,126.99461,37.53345122,8
꾸아퍼스트 센트럴파크점,4,3,126.6335415,37.39368442,7
꾸안,8,9,127.0147083,37.28552128,17
꾼노리 수원역점,3,3,127.0035717,37.2681654,6
꿀밥상,5,5,126.9818513,37.58447522,10
꿈의김밥 잠실점,4,4,127.113265,37.52031449,8
꿉당,5,5,127.0189987,37.51660468,10
꿉당 성수점,5,5,127.0576298,37.54324197,10
꿉통 미아리점,3,3,127.0161343,37.61990246,6
끄레마커피,3,3,126.9502239,37.40578837,6
끌리마,5,5,127.1281191,37.65188204,10
끗집,3,3,126.9919669,37.53499719,6
나나키즈풀빌라,5,5,127.320301,37.78709369,10
나누미떡볶이 성대본점,5,5,126.9979168,37.58370174,10
나는바다다 파주점,5,5,126.7375573,37.71092769,10
나라셀라 롯데백화점 잠실점,4,3,127.0985721,37.51190599,7
나랏님이천쌀밥 본관,9,10,127.4083648,37.30001548,19
나랏님이천쌀밥 신관,5,5,127.4089024,37.29932885,10
나룻배마을,1,1,127.00435,38.095322,2
나리공원,30,33,127.0806334,37.78563737,63
나린띄움,5,5,127.3606602,37.75740215,10
나목카페,5,5,127.1153659,37.89572302,10
나무사이로,4,4,126.9709975,37.57464321,8
나무아래오후N 2호점,8,8,127.3614817,37.7606431,16
나무와베이커리,5,5,126.6976389,37.79196933,10
나미루라멘,2,2,127.1018458,37.48802566,4
나미숍 소나타점,5,5,127.5262064,37.79008667,10
나블리베이커리카페 본점,5,5,127.0763784,37.79424258,10
나산가든,3,3,126.9972134,37.59264678,6
나성타코,5,5,126.9212309,37.55155319,10
나연식당,5,5,127.0246325,37.25640969,10
나우 플랜트,5,4,127.6868224,35.14613371,9
나우커피 차이나타운점,3,3,126.6176903,37.47553071,6
나이스 퍼센트,5,5,127.1354273,37.60147271,10
나이스스크린골프,5,4,126.9709465,37.39100861,9
나이스웨더 마켓,11,13,127.0211751,37.52076965,24
나이쏘이,3,4,127.0267441,37.50189158,7
나이키 명동점,4,4,126.9816366,37.56420281,8
나이키 스타일홍대,8,8,126.9235329,37.55144838,16
나이키 신세계스타필드고양점,5,5,126.8948702,37.64696197,10
나이키 타임스퀘어점,5,5,126.9030811,37.51718742,10
나이키 포천소흘점,3,3,127.1326744,37.80949093,6
나인브릭호텔,3,3,126.9205722,37.55378362,6
나인블럭 FARM고양점,4,5,126.8488411,37.66518028,9
나인블럭 가평점,6,6,127.5243637,37.66184115,12
나인블럭 미음나루DT점,6,6,127.169666,37.58588997,12
나인블럭 뷰팔당점,9,9,127.2551642,37.53994399,18
나인블럭 서종점,5,5,127.3572821,37.60401892,10
나인블럭 출판도시점,3,3,126.6867921,37.70848286,6
나인블럭 프로방스점,5,5,126.6842999,37.79197038,10
나인트 프리미어 호텔 서울 판교,5,5,127.0983333,37.41340311,10
나인트리 호텔 근처 풀숲,3,3,126.9859879,37.5615642,6
나인트리프리미어호텔 명동2,23,23,126.9908319,37.56439849,46
나인트리프리미어호텔 서울판교,106,106,127.1149302,37.31324514,212
나인트리프리미어호텔 서울판교 수영장,5,5,127.0985625,37.4133125,10
나인트리프리미어호텔 인사동,58,57,126.9835789,37.57448345,115
나인트리호텔 동대문,4,3,127.0029475,37.56658283,7
나인호텔,9,8,127.4334326,36.33767491,17
나전칠기체험관,2,4,126.9496269,37.7310322,6
나주소나주곰탕 경복궁점,5,5,126.9731025,37.57636821,10
나주집,5,5,127.0019958,37.53344052,10
나크타,5,5,127.0383361,37.7071123,10
나타드벨렘,5,5,126.9669646,37.39647497,10
나폴레옹과자점 목동점,3,2,126.8814562,37.53636876,5
나폴레옹과자점 양천문화회관점,3,2,126.8624073,37.51660536,5
나향in안국,3,3,126.983902,37.57763698,6
나혜석거리,12,13,127.0346549,37.26386421,25
낙동강 구미환승터미널,5,5,128.3008525,36.343783,10
낙동강구미휴게소 상주방향,13,13,128.3009449,36.34364412,26
낙동강의성충전소,5,5,128.2967652,36.34576572,10
낙산공원,69,74,127.0054562,37.58078446,143
낙산공원 제1전망광장,5,5,127.0074087,37.58164726,10
낙생대공원,5,5,127.1058527,37.38825813,10
낙성대역 2호선,8,8,126.9635239,37.47709324,16
낙성불반집 낙성대점,4,3,126.9623563,37.47665679,7
낙양물사랑공원,4,4,127.0927365,37.74681129,8
낙원백숙닭국수,3,3,126.9893096,37.57170003,6
낙원악기상가,13,12,126.9880959,37.57279192,25
낙원타코 롯데몰수원점,5,5,126.9972898,37.2641684,10
낙원테산도 용산아이파크몰점,4,4,126.9647427,37.52977,8
낙원테산도 타임스퀘어점,3,3,126.903716,37.51723371,6
낙지왕궁,4,4,127.0571525,37.74461032,8
낙천지,1,2,127.3166356,38.06698427,3
난바스낵,5,5,127.0194234,37.56627493,10
난장캠프 논현본점,3,3,127.0252141,37.50574011,6
난지공원 산책로,4,5,126.5211762,33.51393951,9
난지캠핑장,4,4,126.8721662,37.5699951,8
난지한강공원,49,49,126.8756078,37.56703991,98
난지한강공원 잔디마당,5,5,126.8831657,37.56329949,10
난지한강공원 중앙잔디광장,5,5,126.877425,37.56605432,10
난타해물왕칼국수,5,6,127.071506,38.0181716,11
난포,13,13,127.0426842,37.5470172,26
난포 한남점,4,4,126.9995248,37.53713103,8
남경반점,1,3,127.0681127,37.49866378,4
남당항,5,5,126.7370807,37.3797815,10
남대문로 지하쇼핑센터,4,4,126.979007,37.56111736,8
남대문시장,58,57,126.9776268,37.55918176,115
남대문시장부터 숭례문,4,3,126.9753131,37.56000301,7
남도꽃정원,22,21,127.5310991,37.8112803,43
"남도꽃정원, 축제",5,5,127.5310991,37.8112803,10
남도분식 일산가로수길점,4,4,126.7564347,37.66606359,8
남도분식 화성행궁점,5,5,127.012055,37.28645595,10
남도한상 보리굴비,3,4,127.2604863,37.81992874,7
남동공단떡볶이,5,5,126.6938856,37.40942021,10
남동구 공영자전거대여소,8,8,126.7427425,37.40506036,16
남문,4,4,127.5254524,37.79037654,8
남문로데오시장,8,8,127.0155146,37.27460147,16
남문통닭 수원본점,26,26,127.0176355,37.27943616,52
남미플랜트랩,2,4,126.9832309,37.48060801,6
남박,3,4,126.9735719,37.54229711,7
남부골프연습장,5,5,127.1150769,37.26149948,10
남부터미널역 3호선,13,13,127.0162003,37.48519963,26
남사커피,10,10,127.1849682,37.14048634,20
남사화훼집하장,4,4,127.1359104,37.1034758,8
남산,13,13,126.9908881,37.54874277,26
남산3호터널,2,4,126.9856823,37.55005771,6
남산골 한옥마을 윤택영재실,5,5,126.9947485,37.55926666,10
남산골공원,5,5,126.9937526,37.55818901,10
남산골공원 서울천년타임캡슐광장,4,4,126.9938704,37.5573565,8
남산골산채집,10,10,126.9851785,37.55679711,20
남산골한옥마을,20,22,126.994495,37.55930268,42
남산공원,52,54,126.9893169,37.552498,106
남산공원 3.1독립운동기념탑,3,3,127.0019012,37.55264262,6
남산공원 N서울타워,121,125,126.9882306,37.55130497,246
남산도서관 주차장,5,5,126.9818306,37.5531494,10
남산돈가스거리,2,2,126.9858666,37.55697019,4
남산돈까스전문점,4,4,126.9796512,37.55611153,8
남산둘레길,15,15,126.8326414,36.20141042,30
남산서울타워,109,110,126.988217,37.55127974,219
남산야외식물원,4,4,126.9957182,37.54282167,8
남산야외식물원 주차장,5,5,126.9939757,37.54267023,10
남산오르미승강기,3,3,126.9836348,37.55692305,6
남산왕돈까스,4,4,126.7532897,37.50443189,8
남산왕돈까스왕냉면,3,4,126.9231438,37.55561074,7
남산케이블카,42,50,126.9843231,37.55621691,92
남산포레스트게스트하우스,4,4,126.9839784,37.55919361,8
남서울농협하나로마트 양재점,2,2,127.0406787,37.47979129,4
남성주참외휴게소 양평방향,2,3,128.320048,35.8576923,5
남수대반점,5,5,127.0199454,37.28180192,10
남수문,4,4,127.1058999,37.51162124,8
남쓰브레드,4,4,127.0546796,37.17732085,8
남양성모성지,14,15,126.8167578,37.20503699,29
남양조개구이무한리필클램씨,4,3,126.8267387,37.20095763,7
남양주가구스타 남양주점,3,2,127.2872978,37.63046474,5
남양주별내휴게소 포천방향,22,22,127.1305316,37.69136932,44
남양주시립박물관,8,8,127.2443614,37.54641798,16
남영돈,10,10,126.9737754,37.54275036,20
남영역 1호선,3,3,126.971331,37.54056667,6
남오토코 대치점,2,3,127.0623908,37.5072301,5
남원골추어탕,5,5,126.8976095,37.62506955,10
남원추어탕,4,4,126.8749989,37.64682727,8
남이가든,6,8,127.5254323,37.80325483,14
남이밥상,5,5,127.5246369,37.80510352,10
남이섬,137,143,127.5251664,37.79153046,280
남이섬 가평선착장,23,23,127.5258939,37.80429787,46
남이섬 노래박물관,5,5,127.526768,37.79435468,10
남이섬꼬꼬춘천닭갈비,8,8,127.5249061,37.80590597,16
남이섬리베라펜션,10,10,127.5243035,37.80998454,20
남이섬베스트캠핑장,5,5,127.5349316,37.77188597,10
남이섬아띠춘천닭갈비,3,4,127.5242279,37.80891816,7
남이섬안반지닭갈비 1호점,31,31,127.5247001,37.8069664,62
남이섬유원지 메타세쿼이아길,4,4,127.5244807,37.78942766,8
남이아일랜드북까페,5,5,127.5261875,37.7900625,10
남이천배추된장국,5,5,127.4390286,37.16338014,10
남촌순두부 금오점,4,4,127.0685054,37.75203545,8
남촌해장국,5,5,127.352522,37.60275203,10
남춘천역,39,34,127.7238189,37.86405408,73
남춘천역 경춘선,3,3,127.7238507,37.86404667,6
남태령역정류장,5,5,126.9881197,37.46581132,10
남포동직화쭈꾸미 공도점,5,5,127.1959433,37.00896481,10
남한강마트 서종점,3,3,127.3491267,37.60513352,6
남한강막국수 중앙탑점,5,5,127.8640101,37.01835309,10
남한강썬밸리호텔,5,5,127.6611084,37.29318809,10
남한강휴게소,1,1,127.412448,37.5151725,2
남한산성,56,57,127.1800244,37.4789872,113
남한산성 남문,5,5,127.1811775,37.47333431,10
남한산성 빵명장,10,11,127.205237,37.4676997,21
남한산성 서문,10,10,127.1760716,37.48464427,20
남한산성 서문 전망대,10,10,127.1760112,37.48495611,20
남한산성 행궁,48,48,127.1812613,37.47904027,96
남한산성공원,10,9,127.1719338,37.46314508,19
남한산성도립공원 중앙주차장,5,4,127.1870609,37.47710037,9
남한산성둘레길 1코스,14,15,127.1771969,37.47857701,29
남한산성둘레길 2코스,9,9,127.1785867,37.4810617,18
남한산성참먹거리,5,5,127.1854165,37.47777601,10
남한산성행궁 인화관,3,3,127.1828209,37.47786205,6
낫아워스,3,3,126.9136604,37.55322735,6
내가탑게임즈,5,5,126.7612315,37.71478641,10
내리문화공원,5,5,127.030979,36.97492639,10
내린천휴게소 서울방향,5,5,128.2864749,37.91637506,10
내마음속의작은다락방,15,15,127.5347831,37.84024798,30
내마음의숲,10,10,127.0661553,37.77870897,20
내모텔,1,1,127.4457944,37.27738528,2
내사랑동까스,3,4,126.7616089,37.70672978,7
내음685,12,13,127.2276559,37.77731386,25
내추럴가든529,4,4,127.3807815,37.63748902,8
냠냠팩토리,5,5,126.693832,33.43257409,10
냥이툰,4,4,127.1910458,37.56617961,8
너구리베이글,5,5,126.9169731,37.54887701,10
너랑나랑분식카페,1,1,127.402373,37.51283222,2
너를그리다펜션,3,4,127.4531084,37.89891125,7
너프커피,5,5,127.0896309,36.99422666,10
널담은공간 경복궁점,5,5,126.9798355,37.57803099,10
넘버25 방이점,8,9,127.10924,37.51552495,17
넘버25 수원경기대점,5,5,127.0275177,37.29826778,10
넘버25 수원화성행궁점,26,26,127.0179469,37.28025966,52
넘버25 영등포점,4,3,126.908354,37.5179591,7
넘버25 인천신포점,5,5,126.6276001,37.4726413,10
넘버25호텔 동대문점,10,10,127.0068773,37.5652555,20
네로우패스,4,4,127.0008146,37.53618318,8
네버더레스,3,3,126.9937999,37.53332144,6
네스트,4,4,126.9716076,37.57798244,8
네이버 파트너스퀘어 역삼,5,5,127.0352612,37.49979901,10
네이처랩스,3,4,126.9264984,37.55774463,7
네이처스파,9,10,126.7043531,37.7089895,19
네자매평강막국수,5,5,127.5022358,37.67419426,10
네코단,4,4,126.2686621,33.33906784,8
네파 우이플렉스점,3,3,127.0122132,37.66328353,6
넥스트에디션 보네르관,3,4,127.0693624,37.541558,7
넥스트에디션 잠실점,3,3,127.0838235,37.51141191,6
넬보스코 이탈리안 레스토랑,4,3,126.9797388,37.55867939,7
노가리&꼬치,5,5,127.1342142,37.52494532,10
노가리슈퍼 익선점,2,2,126.9900384,37.57285698,4
노들나루공원,3,3,126.9536157,37.5137211,6
노들섬,42,43,126.9580339,37.51766014,85
노들섬 식물도,3,3,126.8359133,33.32711312,6
노들섬라이브하우스,10,10,126.9583277,37.51811975,20
노랑다리미술관,7,8,127.4871133,37.71766992,15
노랑통닭 가평점,3,3,127.5071401,37.83836205,6
노랑통닭 여주1호점,4,4,127.6343796,37.29486881,8
노랑통닭 응암점,4,4,126.9150591,37.58914203,8
노랑풍선시티버스,4,4,126.989803,37.56400557,8
노랑행궁,6,6,127.0168511,37.28628507,12
노래하는분수대,5,5,126.7576883,37.66395067,10
노량진근린공원 송학대공원,5,5,126.9437021,37.50859548,10
노량진수산물도매시장,66,66,126.9368293,37.51473685,132
노량진역 1호선,7,6,126.9421099,37.5140548,13
노량진역 9호선,17,15,126.9408932,37.51358567,32
노량진컵밥거리,27,27,126.8581996,36.80338606,54
노루목민박,5,5,127.4737184,37.37609757,10
노룬산골목시장,4,4,127.0650628,37.53659053,8
노마드 캠핑 화성지점,5,5,126.8849031,37.08909697,10
노마드호텔,5,5,127.2938012,37.04600615,10
노무현시민센터,13,13,126.9888905,37.5807604,26
노보텔 동대문 루프톱 수영장,5,5,127.004571,37.566425,10
노보텔 스위트 앰배서더 서울 용산,15,15,126.9627868,37.53180566,30
노보텔 앰배서더 서울 강남,52,52,127.0289259,37.50534011,104
노보텔앰배서더 더스퀘어,4,4,127.0289191,37.5053293,8
노보텔앰배서더 서울동대문호텔,5,5,127.0045819,37.56630887,10
노보텔앰배서더 서울동대문호텔&레지던스,103,101,127.0045814,37.56631415,204
노보텔앰배서더 서울동대문호텔&레지던스 수영장,4,5,127.0045819,37.56630887,9
노보텔앰배서더 서울동대문호텔&레지던스 푸드익스체인지,5,5,127.0043782,37.56629807,10
노보텔앰배서더 서울용산,60,62,126.9632077,37.53178958,122
노보텔앰배서더 수원,5,5,126.9990079,37.26854028,10
노브랜드,4,4,127.0089912,37.5691235,8
노브랜드 가평잣고을시장점,3,3,127.5152359,37.82976613,6
노브랜드 강남삼성점,4,4,127.0511819,37.51622841,8
노브랜드 강남터미널점,5,5,127.0069714,37.50605704,10
노브랜드 수원천천점,5,5,126.9790303,37.29967474,10
노브랜드 스타필드하남점,3,4,127.2243311,37.54567837,7
노브랜드 안성공도점,3,3,127.1766367,37.00356971,6
노브랜드 하남미사2동점,4,4,127.1947745,37.56888371,8
노브랜드버거 고속터미널점,5,5,127.0056888,37.50517503,10
노브랜드버거 부평역점,4,4,126.7247277,37.49106457,8
노브랜드버거 서울시청점,3,3,126.9790369,37.56740091,6
노브랜드버거 안산중앙점,4,4,126.8363267,37.31925913,8
노브랜드버거 안성스타필드점,4,5,127.1470208,36.99459747,9
노브랜드버거 역삼역점,5,5,127.0370262,37.50125449,10
노브랜드버거 천호역점,4,4,127.123389,37.53936232,8
노블글램핑,3,3,127.2510739,37.86505982,6
노스페이스 타임스퀘어점,4,3,126.9030962,37.5171395,7
노원문화의거리,7,7,127.0628665,37.65488558,14
노원역 4호선,7,7,127.0634491,37.65634035,14
노을공원,4,3,126.8758134,37.57410032,7
노을진캠핑장,4,4,126.6571328,37.56977005,8
노작골부대찌개 닭갈비는저녁짝꿍,2,3,127.077102,37.19737214,5
노적봉폭포공원,4,3,126.8550023,37.31648758,7
노점 분식집,3,3,126.9555823,33.50441997,6
녹사다리,5,5,126.9875317,37.53483463,10
녹사다리.이태원클라스 촬영지,4,4,126.9875317,37.53483463,8
녹사평보도육교,4,4,126.9870565,37.53493549,8
"녹사평역 육교, 산책길",5,5,127.7849598,36.1616778,10
녹수계곡,3,3,127.3958498,37.78200884,6
녹야선원,4,4,127.0312613,37.69206449,8
녹원쌈밥,5,5,126.9341543,37.57247503,10
녹턴,2,2,126.7241344,37.49496634,4
논두렁 밭두렁,4,5,126.9070056,37.98398794,9
논두렁밭두렁,3,3,127.3328795,37.34498797,6
논산역,4,4,127.0924438,36.20732873,8
논탄토,5,5,127.0238799,37.52090879,10
논픽션 삼청,17,17,126.9804078,37.58010607,34
논픽션 성수,6,8,127.0437142,37.54750967,14
논현역 신분당선,12,12,127.0216789,37.51041252,24
놀로 아쿠아센터,5,5,127.0489851,37.51947205,10
놀부네감자탕,5,5,126.8195668,37.20996103,10
놀부보쌈 을지로6가점,4,4,127.007602,37.56759534,8
놀부부대찌개 과천점,4,4,126.9919965,37.426959,8
놀부부대찌개 영등포타임스퀘어점,2,2,126.903716,37.51723371,4
놀부주방 반포점,8,9,127.0069827,37.50608407,17
놀숲 동탄남광장점,5,5,127.0732094,37.20215379,10
놀숲 사당역점,5,5,126.9814324,37.4746755,10
놀숲 서울대입구역점,3,4,126.9520814,37.47916868,7
놀숲 송파점,3,3,127.1085257,37.50653719,6
놀숲 신사가로수길점,4,4,127.0224288,37.5181502,8
놀자노래방,2,2,127.0699443,37.54071702,4
놀자숲,10,10,127.1372191,37.88557745,20
농가,4,4,127.3117646,38.15861613,8
농가보쌈족발 곤지암점,4,4,127.331402,37.34185744,8
농민백암순대,5,5,126.977164,37.56259465,10
농민백암순대 본점,5,5,127.0530077,37.50370815,10
농부네쉼터,5,5,127.4286295,37.59928545,10
농심가락 에스에스하지점,4,4,128.2507365,36.2742279,8
농심가마트 오남점,2,2,127.2116399,37.68439405,4
농업생태원,4,4,126.9482892,37.54184816,8
농업회사법인 연천양조,4,4,127.0414895,38.08330104,8
농우본수원갈비,1,1,127.0899424,37.27314468,2
농장사람들,4,3,127.2160487,37.54007609,7
농협 하나로 마트,5,5,129.0453249,35.5482143,10
누구나,5,5,126.9842772,37.56969926,10
누데이크 성수점,8,9,127.0542453,37.54158754,17
누데이크 하우스도산,20,20,127.0356805,37.52536578,40
누들코드,4,4,127.1921641,37.56262157,8
누리꿈스퀘어,3,3,126.8896613,37.57949211,6
누메로뜨레쓰,9,8,127.0486743,37.54253421,17
누볼라,5,5,127.0277049,37.49439318,10
누에섬,8,8,126.631912,37.18740404,16
누에하우스,2,3,126.9904789,37.56268657,5
누이테이블,4,4,127.0532466,37.55018713,8
누하스 라운지,10,10,127.0003349,37.53625887,20
누하스플레이,5,5,127.0983344,37.41340401,10
뉴국제호텔,13,13,126.9779592,37.56790707,26
뉴뉴,3,2,127.0135061,37.56780384,5
뉴발란스 홍대직영점,2,2,126.922835,37.55438698,4
뉴블랙,5,5,126.9219117,37.55202486,10
뉴서울호텔,18,19,126.9781765,37.56801523,37
뉴스프링프로젝트,5,5,126.9984194,37.53646699,10
뉴오더클럽,4,5,126.924553,37.56105908,9
뉴욕버거 광화문점,5,5,126.9755613,37.56951758,10
뉴욕버거 동대문종합시장점,3,3,127.007386,37.5701686,6
뉴욕버거 홍대점,5,5,126.9207067,37.54855431,10
뉴욕베이글앤크림치즈 송도점,4,3,126.646853,37.39333929,7
뉴웨이브서울,4,5,127.0707826,37.54171123,9
뉴질랜드스토리,4,5,127.105843,37.50970395,9
뉴캐슬호텔,1,1,127.1371287,37.59926693,2
뉴코아백화점 일산점,5,5,129.0574038,35.1683563,10
뉴코아아울렛 강남점,3,3,127.0075779,37.50921413,6
뉴코아아울렛 광명점,8,8,126.8792919,37.46110014,16
뉴코아아울렛 동수원점,10,9,127.0342693,37.2662593,19
뉴코아아울렛 부천점,20,19,126.7565233,37.5047062,39
뉴코아아울렛 평촌점,4,4,126.9512274,37.38920458,8
뉴코아아울렛 평택점,3,3,127.1124498,36.99574359,6
느루,5,5,126.9696864,37.53066787,10
느루집,5,5,126.8964932,37.51746276,10
느만장,5,5,127.7914317,37.90279127,10
느티나무 바베큐 곤지암리조트,5,5,127.2953076,37.3372414,10
느티나무그늘아래 캠핑장,8,8,126.7565224,37.87585444,16
늘상웨돔,5,5,126.771001,37.6572884,10
늘솜당,4,5,126.7844218,37.47091231,9
늘포레,5,5,126.6046369,37.23889914,10
늘푸른목장,3,4,127.189199,37.56633756,7
늘푸른정원,3,3,127.2796317,37.615334,6
늠내길 갯골길,4,4,126.778084,37.39223838,8
능골매운탕,4,4,126.8263101,37.74059682,8
능내역 (폐역),16,17,127.2962658,37.52364447,33
능내역 인증센터,5,5,127.2949028,37.52224953,10
능라도 강남점,3,3,127.0555342,37.50967705,6
능라도 광화문점,2,3,126.9723163,37.57170808,5
니드썸레스트,12,12,127.4879481,37.80335118,24
니어스,5,5,127.0117625,37.28370782,10
니지모리스튜디오,35,42,127.0919736,37.87915944,77
니커버커베이글,8,9,127.105713,37.50981579,17
니폰식,3,3,126.7875999,37.64424171,6
닛다,4,4,126.9552619,37.91475394,8
다나호텔,4,4,126.9900683,37.5691629,8
다님길,5,5,127.023616,37.50909668,10
다다오피스텔,4,4,126.6765846,37.46062193,8
다둥이네캠핑장,5,5,127.5637198,37.93525095,10
다락호텔,4,4,127.0239125,37.5733271,8
다래함박스테크,5,5,127.0188718,37.6327287,10
다마네기,3,3,127.2247177,37.57683854,6
다만프레르 SFC점,12,14,126.9782851,37.56840358,26
다미,5,5,126.9199005,37.52999317,10
다미 쉐어하우스,1,1,127.0495316,37.5908203,2
다발김치찌개 대학로점,5,5,126.998338,37.5836549,10
다봄안과의원,1,3,127.0921478,37.82103303,4
다비치안경 명동점,1,3,126.9821898,37.56084758,4
다산생태공원,44,43,127.2139285,37.09127027,87
다산제일약국,3,3,127.1647771,37.6094605,6
다슬기해장국전문,3,4,127.4912991,37.9407097,7
다온 가평숯불닭갈비,3,4,127.5302967,37.67091804,7
다온무인텔,2,3,126.686597,37.78060641,5
다온재,4,4,126.9824743,37.5831959,8
다운타우너 갤러리아광교,9,9,127.0572634,37.2853038,18
다운타우너 안국,17,20,126.9862477,37.57746248,37
다운타우너 연남,3,5,126.9201368,37.55771167,8
다운타우너 잠실,9,9,127.1106714,37.50898413,18
다운타우너 한남,5,5,127.0008599,37.53484069,10
다원김밥,3,3,126.8275554,37.56731377,6
다이너,3,3,126.7613018,37.7158542,6
다이소 강남고속버스터미널점,4,4,127.0072971,37.50620479,8
다이소 공릉점,4,4,127.0745071,37.62643923,8
다이소 광명사거리점,5,5,126.8542669,37.47974446,10
다이소 광명하안점,3,4,126.8760564,37.46009847,7
다이소 남양주오남점,2,3,127.2106129,37.68462771,5
다이소 노원문화의거리점,4,4,127.0624514,37.65575885,8
다이소 대학로점,4,4,127.0019473,37.5835738,8
다이소 동서울터미널점,5,5,127.0941838,37.53462113,10
다이소 마석역점,3,3,127.3098605,37.65186001,6
다이소 발산역점,5,5,126.8384191,37.55803897,10
다이소 분당이매점,5,5,127.1223815,37.40523905,10
다이소 서울대입구점,4,5,126.9544775,37.48034455,9
다이소 송도트리플스트리트점,5,5,126.663103,37.37879379,10
다이소 수원남문점,5,5,127.0182078,37.27739432,10
다이소 수원인계본점,4,4,127.0336545,37.26536023,8
다이소 신림역1호점,3,3,126.9299428,37.48599449,6
다이소 신사역점,2,2,127.0201568,37.51586927,4
다이소 신촌본점,5,4,126.9355456,37.55532444,9
다이소 안성옥산점,4,3,127.2490759,37.01234066,7
다이소 압구정역점,4,5,127.0289388,37.52709394,9
다이소 여의도점,5,5,126.9259895,37.52308466,10
다이소 연희동점,3,3,126.9297368,37.56576548,6
다이소 영등포역점,5,5,126.9061674,37.51796729,10
다이소 용인동천점,5,5,127.0951086,37.33938116,10
다이소 용인중앙시장점,3,3,127.204663,37.23495633,6
다이소 위례본점,5,5,126.6989531,37.78817425,10
다이소 이태원점,7,8,126.9901702,37.53459701,15
다이소 인천당하점,3,3,126.674788,37.59392148,6
다이소 인천송도1호점,4,4,126.6518265,37.39623369,8
다이소 종로본점,8,8,126.9873561,37.56989785,16
다이소 천호점,4,3,127.1249605,37.54129241,7
다이소 춘천온의점,4,4,127.7210467,37.86598467,8
다이소 평택역점,4,4,127.0876683,36.99124374,8
다이소 홈플러스일산점,4,4,126.7693278,37.6589069,8
다이소 홍대2호점,5,5,126.9255885,37.55776208,10
다이소 화성남양점,4,4,126.8181996,37.20885605,8
다전1973,5,5,127.0125803,37.28491332,10
다정면가 멸치국수와돈까스,5,5,127.0597892,37.17661105,10
다찌,5,5,127.0789277,37.79568965,10
다츠,3,4,126.9991989,37.5365652,7
다피타 여주점,5,5,127.637582,37.25055267,10
다향아트밸리,4,4,127.0861732,34.71578025,8
닥터로빈 강서점,4,4,126.851113,37.55581398,8
단골집,5,5,126.8371001,37.8293209,10
단구주유소,3,3,127.9702293,37.31646236,6
단디 송리단길본점,5,5,127.1103438,37.50923131,10
단미,5,5,127.3109353,37.3643206,10
단밥,5,5,127.2361493,37.54171346,10
단백하루,3,3,127.0272477,37.51826812,6
단상,5,5,126.9864151,37.57795624,10
단양역,5,5,128.3437007,36.97324701,10
단양팔경휴게소 춘천방향,4,3,128.3221759,36.94287649,7
단오,3,4,127.01474,37.28010873,7
단월산,5,5,127.6017439,37.58071561,10
단지커피,5,5,127.0742131,37.55397442,10
달래해장 논현영동시장점,4,4,127.024244,37.5066278,8
달래해장 명동점,4,4,126.9855679,37.56264823,8
달래해장 샤로수길점,5,5,126.9563147,37.47849997,10
달래해장 역삼점,1,1,127.0348787,37.49432461,2
달마사,5,5,126.9627082,37.49872799,10
달맞이광장,6,7,127.654356,37.29795778,13
달문식당,5,5,127.0708495,37.54903901,10
달밤막창,5,5,127.0697788,37.27368449,10
달밤엔씨어터,3,3,127.002681,37.58400086,6
달볶이 숙명여대점,4,4,126.9657087,37.54515757,8
달빛새 베이커리앤카페,2,3,127.1631646,37.6944893,5
달빛새베이커리앤카페,3,4,127.1631646,37.6944884,7
달빛어린이공원,2,3,127.0546235,37.17762993,5
달빛에구운고등어 관저점,4,4,127.3367391,36.29657995,8
달빛여관모텔,3,3,127.0143844,37.29003192,6
달수네소곱창,4,4,127.0228141,37.51647787,8
달인맛집,3,3,126.937288,37.77677559,6
달짜국수,3,3,126.9750573,37.51936875,6
달쭈꾸미,4,5,126.5977089,37.47478862,9
달카페,4,5,126.9820236,37.5837555,9
달콤커피 분당서현점,3,4,127.1212343,37.38655304,7
달콤커피 에버랜드가든점,3,3,127.1994319,37.2905775,6
달콤커피 청계광장점,7,8,126.9796974,37.56947782,15
달콤커피 한남동점,3,3,127.0063132,37.53336468,6
달콤한게으름놀이터,3,3,126.7022184,37.45411914,6
닭갈비타운,9,9,127.5141941,37.82663538,18
닭강정공방 시흥시청점,3,3,126.7994708,37.38140935,6
닭나무집,5,5,127.0300665,37.26374653,10
닭발여행 윤이불닭발,4,4,127.0282463,37.49982342,8
닭이닭숯불닭갈비 오산양산점,5,5,127.0348915,37.19024854,10
닭장,4,4,127.0189314,37.5901081,8
닭진미,5,5,126.9770472,37.55956187,10
닭향,5,5,126.5887855,37.62809867,10
담다,5,5,127.4648536,37.54376643,10
담쁨퍼스널컬러,3,3,126.927347,37.55564764,6
담소소사골순대육개장 북창점,3,3,126.9774534,37.56371194,6
담솥 익선직영점,8,12,126.9897147,37.57297228,20
담장옆에 국화꽃 안녕인사동점,7,8,126.983554,37.57446723,15
담장옆에국화꽃 파미에점,3,4,127.0065957,37.50400277,7
담하,4,4,127.2944446,37.33733383,8
답다,5,5,127.0363605,37.4858655,10
답십리영화미디어아트센터,5,5,127.0637588,37.57179142,10
당거쉼터,5,5,126.9804652,36.99215036,10
당고개역 4호선,3,3,127.0790666,37.67021684,6
당남리섬 (휴업중),14,14,127.5425717,37.39505098,28
당남리섬 가족피크닉존,7,8,127.543224,37.39217916,15
당남리섬 둘레길,5,5,126.5287906,33.51265509,10
"당남리섬, 이포보 오토캠핑장 및 둘레길",4,5,126.499364,33.488414,9
당도,12,12,126.9048652,37.55642454,24
당빛,3,4,127.4427474,37.40535642,7
당산골 거리,9,10,126.4880564,33.47037471,19
당산나루소공원,3,3,126.9007227,37.53280415,6
당산오돌 구의역점,3,3,127.0841174,37.53743625,6
당산오돌 인덕원점,5,5,126.9744162,37.40248483,10
대가설렁탕,3,3,126.9503792,37.40667053,6
대가주점,5,5,127.0018805,37.26743019,10
대갈장군찜,3,3,127.1837236,37.72028096,6
대공원역 4호선,9,9,127.0067525,37.43605574,18
대공원포도밭,4,4,127.0031966,37.43638206,8
대관령농협하나로마트,4,4,128.7036555,37.67344976,8
대광식품,4,4,127.0417512,37.57038849,8
대구스타디움,5,5,128.690218,35.82985821,10
대구역,8,7,128.5962772,35.87594877,15
대농석유 남태령주유소,5,5,126.9878731,37.46683664,10
대덕테크노밸리6단지네오미아아파트,4,1,127.3891376,36.41904629,5
대도곱창 동탄점,5,5,127.1112414,37.20758455,10
대동강,2,2,127.3198027,37.33723016,4
대동집 송탄출장소점,2,3,127.0624741,37.06751969,5
대련집,5,5,126.9889184,37.56839335,10
대륭테크노타운19차,5,5,126.8824625,37.4747987,10
대릉원,3,3,129.2123347,35.83815,6
대림국수 안국점,4,5,126.9863064,37.57794902,9
대림국수 을지로점,2,2,126.9954101,37.56741529,4
대림상가,4,4,126.9930542,37.57167509,8
대림역,3,3,126.5350025,33.51959286,6
대림역 2호선,4,4,126.894931,37.49330994,8
대림차이나타운,5,5,126.8974743,37.49240396,10
대림창고,18,18,127.0562482,37.54171995,36
대맛초,6,6,127.3265464,37.35601975,12
대명에너지세교주유소,4,4,127.06424,37.16670792,8
대명항대명포구,4,4,126.5417278,37.63937221,8
대명항수산물직판장,9,9,126.5416084,37.63961681,18
대물림안성장터국밥,5,5,127.2513819,36.98375984,10
대박고깃집,5,5,127.0298619,37.25933147,10
대박꽃돼지정육식당 용이점,2,2,127.1275794,36.99298359,4
대방역,3,3,126.4883977,33.47077732,6
대방역 1호선,18,18,126.9264945,37.51335414,36
대복관,2,2,127.0811891,37.987663,4
대봉통닭,11,11,127.0178836,37.27967039,22
대부객주,5,5,126.5517298,37.28038177,10
대부도,9,9,126.5967681,37.24613859,18
대부도 16호원조칼국수,5,5,126.5767127,37.2466407,10
대부도 방아머리먹거리타운,2,3,126.5762166,37.28842989,5
대부도 방아머리해수욕장,5,5,126.4883254,33.47136847,10
대부도 유채밭,5,5,126.5678473,37.27294511,10
대부도오션시티 종합어시장,9,9,126.5738152,37.28631285,18
대부도펜션시티,5,5,126.5895455,37.23620234,10
대부도펜션타운,5,5,126.6243831,37.23313188,10
대부도포도빵,4,4,126.5738015,37.28635605,8
대부바다향기 테마파크 습지테마원,5,5,126.5765791,37.27929111,10
대부바다향기테마파크,13,13,126.5745552,37.28627587,26
대부해솔길 1-1코스 순환노선,4,4,126.5664476,37.27322382,8
대부해솔길 1코스,4,4,126.551439,37.27999142,8
대불호텔 전시관,14,14,126.6199726,37.47356487,28
대선칼국수,5,5,126.9726358,37.57719341,10
대성공판장,10,10,127.379317,37.68502564,20
대성리국민관광유원지,3,3,127.379854,37.68005415,6
대성리맷돌손두부,3,3,127.3778601,37.67942266,6
대성리억새공원,2,2,127.3808614,37.68286554,4
대성리역 경춘선,3,3,127.3797063,37.68399007,6
대성수상레저,3,4,127.3795209,37.68143191,7
대성연탄갈비,3,4,127.1098131,37.51445763,7
대세노가리,3,3,126.6103491,37.67663453,6
대소버스공동정류장,10,10,127.4826196,36.96962435,20
대승원,10,11,127.012602,37.27982425,21
대신농협하나로마트,5,3,127.5788924,37.37479159,8
대신체육공원,3,1,127.5811755,37.37395326,4
대오서점,5,5,126.9693065,37.57974782,10
대왕공원,3,3,127.1045984,37.46236971,6
대왕김밥 별관,5,5,126.7214774,37.49425371,10
대우도씨에빛1오피스텔,8,8,127.028343,37.49532287,16
대운이엔지주유소,2,2,129.2042153,35.18996818,4
대웅경영개발원 바이오센터,4,3,127.238071,37.27985944,7
대원미디어,3,3,126.9645802,37.52894103,6
대장장이화덕피자,3,3,126.985355,37.58055098,6
대전도룡고속시외버스정류장,9,8,127.3773011,36.38872216,17
대전복합터미널,23,23,127.4367522,36.35032438,46
대전신세계 아트앤사이언스,4,4,127.3813771,36.37524213,8
대전역,103,105,127.4341122,36.33229969,208
대전청사시외버스둔산정류소(하차),4,4,127.3828093,36.35823062,8
대조전통시장,4,4,126.92777,37.60984805,8
대중음악박물관,3,2,129.2892761,35.8401298,5
대진대학교,3,2,127.1561217,37.87068466,5
대천휴게소 목포방향,4,4,126.5557174,36.37297909,8
대천휴게소 서울방향,3,3,126.5583353,36.37431712,6
대치유수지체육공원,5,5,127.0689916,37.50258085,10
대판1985,3,4,126.6467123,37.39347582,7
대하횟집,4,4,126.6184389,37.16216084,8
대학교,4,4,127.0549831,37.9333158,8
대학로거리,5,5,127.0034236,37.58265296,10
대학로수제모찌,4,4,127.0021873,37.58251603,8
대학로예술극장,3,3,127.0032288,37.58196821,6
대한민국역사박물관,15,16,126.9778578,37.57398697,31
대한민국역사박물관 .광화문광장,4,4,126.9778578,37.57398697,8
대한불교 조계종 심학산 약천사,3,4,126.701138,37.70562257,7
대한불교조계종 신륵사,11,11,127.6615526,37.29755376,22
대한불교조계종용문사 전통다원미르,5,5,127.5721686,37.54930298,10
대한성공회 인천내동교회,4,4,126.6274724,37.47400322,8
대호모텔,1,1,126.8951728,37.47246083,2
대홍샤브샤브뷔페,5,5,126.9081365,37.51454143,10
대화벌교꼬막,5,5,126.7563093,37.67805354,10
대화빌딩,4,4,127.0642306,37.51078628,8
대화역 3호선,21,21,126.747501,37.67615738,42
대화정진짜해장국,6,6,127.0077423,37.56755569,12
대흥역 6호선,5,5,126.9424732,37.54764791,10
댓돌,8,8,127.1006602,37.84006865,16
댕리단길,3,3,126.9157577,37.40082854,6
더 가든키친,3,3,127.0183171,37.51844103,6
더 레드락,3,3,126.7254334,37.49352055,6
더 포레스트갤러리 펜션,4,4,127.4365034,37.59509764,8
더 플라자 라운지,5,5,126.9779149,37.56467069,10
더 하버 레스토랑,5,5,126.6195509,37.4721353,10
더AW컨벤션웨딩,4,4,127.2495976,36.99696805,8
더그레이호텔,5,5,126.9153167,37.56965912,10
더그린가든센터,5,5,126.8529365,37.68847484,10
더그림,19,19,127.4969906,37.52857817,38
더글라스하우스,4,4,127.1089806,37.5558804,8
더달달,3,2,127.0284862,37.50319222,5
더도어즈이스케이프,4,4,126.7656246,37.66454694,8
더드림호텔,2,4,127.2043355,37.89772482,6
더레퍼런스,3,3,126.9718052,37.58230005,6
더로열푸드앤드링크,5,5,126.9839764,37.54717429,10
더리버사이드호텔,12,11,127.0180852,37.51856901,23
더리프 사당,8,8,126.9811258,37.47571702,16
더모스트펜션,3,5,127.355201,37.75437078,8
더반올가닉,5,5,127.5093767,37.27169644,10
더백푸드트럭 더현대서울점,2,1,126.9283217,37.52581794,3
더백푸드트럭 해방촌점,3,4,126.9840443,37.54746622,7
더벙커,5,5,127.4199768,37.46348615,10
더베이커스가든 화도본점,5,5,127.2988236,37.66892598,10
더베이크 센터마크호텔점,4,4,126.9841974,37.57259325,8
더베일리하우스 삼성점,5,5,127.0631011,37.50996517,10
더벤티 김포마송점,3,3,126.5978425,37.68944041,6
더블라썸,12,12,126.9244016,37.56300874,24
더블리스,4,4,126.9777081,37.56338943,8
더블제이 케이크앤마카롱,3,3,126.6846614,37.48653148,6
더블하모니,5,5,126.9131471,37.55466857,10
더비기닝,5,5,126.6314437,37.47195237,10
더빛남,5,5,127.1108089,37.51019134,10
더빨간짬뽕,5,5,127.0974198,37.74645072,10
더샵부평센트럴시티아파트,5,5,126.6984653,37.4771475,10
더수제비 남양주본점,6,9,127.3377828,37.59188238,15
더숲 초소책방,4,4,126.9642679,37.58594884,8
더숲초소책방,10,10,126.9642679,37.58594884,20
더스크블루,5,5,126.8991442,37.52877714,10
더스크커피,4,4,126.9924757,37.56038016,8
더스키앤커피,3,3,127.0041254,37.58103114,6
더스타,2,2,126.938133,37.55781257,4
더스타갤러리,4,4,126.9851141,37.57371781,8
더스테이송도,24,24,126.6289544,37.40603566,48
더스테이트 선유,26,27,126.8933695,37.53858576,53
더스테이호텔,2,5,126.9867485,37.56186811,7
더스테이힐링파크 내 알파와앵무,3,4,127.1525571,35.81482431,7
더스테이힐링파크 퍼블릭,5,5,127.5233803,37.66091932,10
더스틸카페,7,7,127.5257093,37.80580869,14
더스팟 패뷸러스,9,9,126.9826014,37.56233248,18
더씨,5,5,126.9171389,37.54936997,10
더워크,9,9,127.0019276,37.43295823,18
더웰빙카페,2,3,127.0218008,37.50581737,5
더조커,4,4,126.9209863,37.55173322,8
더존카라반&글램핑,4,4,127.380397,38.03274776,8
더좋은서울치과,4,4,127.0024397,37.2673653,8
더지스치즈카페,4,4,126.9822757,37.99843465,8
더진국 가평점,5,5,127.5125295,37.8303185,10
더진국 안산고잔점,3,3,126.8363998,37.31729228,6
더캡슐 명동점,10,9,126.9988568,37.56352037,19
더커피106,4,4,127.4973048,37.59766818,8
더커피에반하다,4,3,126.6954572,37.79130781,7
더컨벤션 잠실점,5,5,127.1060212,37.51575493,10
더케이즈,11,10,127.3410092,37.94026044,21
더코노셔레지던스,4,4,126.9201286,37.52824899,8
더큐리키즈카페,5,5,126.6280612,37.40508679,10
더큐브호텔,5,5,126.9862058,37.55881907,10
더큐이스케이프45 홍대입구역점,3,4,126.9227072,37.55534196,7
더키월드,8,8,126.9259742,37.55686854,16
더키친일뽀르노 광화문점,5,5,126.9813939,37.57508319,10
더티래빗(2호점),3,3,127.0173459,37.28510554,6
더티트렁크,33,32,126.7029976,37.72838216,65
더파운틴,3,4,126.9929806,37.53520268,7
더파이브올스,5,5,126.928479,37.55545732,10
더파크츄러스 낙산공원점,5,5,127.0054206,37.58056978,10
더파티움 여의도,5,5,126.9227082,37.52814168,10
더페이스샵 영등포지하상가점,3,3,126.9061579,37.51746182,6
더페이지갤러리,7,7,127.0429143,37.54567553,14
더포레스트원,9,9,127.7217978,37.52869664,18
더푸드하우스 수서역사점,3,3,127.1044833,37.48526267,6
더푸짐,5,5,126.9991415,37.41122749,10
더푸짐한밥상,5,5,127.275411,37.0053667,10
더풋샵 강남역점,4,4,127.0262137,37.49859041,8
더풋샵 명동아르누보점,5,5,126.9838595,37.5647221,10
더플라스틱 클라이밍,5,5,126.8957272,37.5136121,10
더플라자,18,18,126.9781107,37.56469235,36
더플래츠,8,9,127.3630863,37.76201213,17
더플러스성형외과,3,3,127.0230217,37.51857536,6
더플레어,3,3,126.9855858,37.56932011,6
더플레이스 잠실롯데백화점,4,4,127.0985167,37.51188711,8
더플레이스 코엑스점,5,5,127.0588254,37.51242892,10
더플레인,4,4,126.9854444,37.56310412,8
더플레인 영등포점,5,5,126.5581237,33.42374026,10
더피아1972,2,2,126.9766551,37.56837714,4
더피터커피,4,5,127.0172172,37.56592658,9
더하우스1932,5,5,126.9673789,37.55554295,10
더하이브,5,5,127.3279782,37.65195149,10
더한강,6,6,128.0873761,36.3521645,12
더할랄가이즈 이태원점,5,5,126.9947864,37.53470903,10
더현대서울,425,439,126.9284459,37.52587232,864
더현대서울 6층,3,3,126.9284261,37.5258975,6
더현대서울 매직샷 전시회,3,3,126.9284261,37.5258975,6
더호텔 문,3,3,126.9071711,37.51857356,6
더휴식 이로호텔 월곶지점,9,9,126.7413209,37.39113561,18
더휴식 크로와상호텔 구리지점,4,4,127.1368362,37.59781847,8
더휴웨딩홀,7,7,127.0501022,37.5053042,14
더힐하우스호텔 양평,8,7,127.4400633,37.50556551,15
덕부네한식뷔페,3,3,127.1287915,37.65283094,6
덕성여자고등학교,1,2,126.9832045,37.57814324,3
덕소강변삼익아파트,4,3,127.207555,37.58635291,7
덕송천,4,4,127.1206233,37.66121871,8
덕수궁,223,234,126.9587077,37.48043691,457
덕수궁 리에제와플,11,12,126.9764525,37.56479294,23
덕수궁 석조전대한제국역사관,20,20,126.9742289,37.56639985,40
덕수궁 중명전,5,5,126.9725219,37.56673464,10
덕수궁돌담길,92,93,126.9756646,37.56497658,185
덕암사,5,4,127.1195582,37.59910584,9
덕정시장,4,5,127.0634684,37.84361549,9
덕정역 1호선,4,4,127.0615593,37.84318765,8
덕차이,2,4,127.2162489,37.58743921,6
덕평공룡수목원,10,10,127.3372268,37.23231754,20
덕평자연휴게소 강릉방향,10,10,127.389563,37.24183413,20
덕평자연휴게소 인천방향,17,17,127.3898083,37.24132153,34
덕포진,5,6,126.5355823,37.65103925,11
덕풍전통시장,3,3,127.20353,37.54181023,6
덕후선생 광화문점,9,9,126.9789272,37.57106794,18
던킨,5,5,126.7403191,37.8915772,10
던킨 영등포역사점,3,3,126.9074733,37.51573023,6
던킨 진주평거퀸즈웰가점,3,5,128.0507156,35.1661836,8
던킨도너츠 신대방삼거리점,2,2,126.9300704,37.49952048,4
던킨도너츠 청주터미널점,3,3,127.4328755,36.62594065,6
던킨도넛츠,3,3,126.7855783,37.59932841,6
덤앤더머 홍대점,5,5,126.9198929,37.54981877,10
덧정하우스,5,5,127.2511481,37.33628304,10
덮밥장사장 미사점,5,5,127.1892203,37.56627896,10
데니스스모크하우스,6,7,126.9713523,37.71226142,13
데블스도어 센트럴시티점,5,5,127.0092106,37.50499731,10
데일리라이크 세로수길점,12,12,127.0206788,37.52189149,24
데일리베이커리,4,4,127.0332432,37.20679954,8
데일리오아시스 남양주별내점,3,3,127.127072,37.65719356,6
데일리오아시스 샤로수길점,5,5,126.9565908,37.47814688,10
데일리오아시스 송도센트럴파크점,7,7,126.6446437,37.3857533,14
델레떼,5,5,127.3273998,37.54431133,10
델루나김밥,5,5,127.2106971,37.23756959,10
델리 압구정점,5,5,127.0364148,37.52786313,10
델리빈 카페,4,4,126.7019821,37.45102628,8
델리카한스 롯데호텔서울,8,8,126.9809617,37.56535597,16
델리커리 동대문점,3,3,127.0099382,37.56720233,6
델리커리 동탄라크몽점,8,8,127.1051513,37.16689493,16
델리커리 목동41타워점,4,4,126.8757719,37.52817822,8
델리커리 인천앨리웨이점,5,5,126.6645319,37.46954614,10
델비노,1,1,127.1111799,37.55437607,2
델씨엘로,5,5,127.4336987,37.75286113,10
도깨비도로,1,4,127.0273562,37.3939932,5
도너츠윤 대부도,9,9,126.5738015,37.28635605,18
도너츠윤 동두천본점,5,5,127.0422563,37.90416697,10
도농역 경의중앙선,4,4,127.1611787,37.6087726,8
도담곤드레한정식,4,4,126.8154128,37.60283323,8
도담도담식빵 양평점,4,3,127.4922546,37.49513142,7
도당근린공원 백만송이장미원,5,5,126.7922358,37.5165352,10
도대리등산로,3,3,127.4709318,37.9569708,6
도덕산,9,8,126.85722,37.46546707,17
도래울파크뷰아파트,5,5,126.8687969,37.62709978,10
도레도레 김포롯데몰점,4,4,126.8032209,37.56324377,8
도레도레 서울역점,3,3,126.9707148,37.55366254,6
도리스,4,4,127.1897086,37.56330309,8
도림동공영주차장,5,5,126.8967694,37.50831151,10
도림천,3,3,126.9338222,37.47177609,6
도마 유즈라멘,5,4,126.986517,37.57782651,9
도마 인사점,10,10,126.9858453,37.57377917,20
도미노피자 배방점,4,4,127.0775056,36.77140038,8
도미인서울강남호텔,10,10,127.0294745,37.5056283,20
도봉산,5,6,127.0154586,37.69884206,11
도봉산공영주차장,4,4,127.0407058,37.68768647,8
도봉산역 1호선,4,4,127.0460627,37.68951168,8
도봉산역 7호선,4,4,127.0464256,37.68963047,8
도비네꽃도리탕,5,5,127.1302697,37.43199446,10
도산공원 도산안창호기념관,5,5,127.0355079,37.52392062,10
도산근린공원,22,22,127.0352876,37.52455769,44
도산맘마,10,10,127.0346445,37.52591389,20
도새기식당,5,5,126.9159533,37.61958532,10
도서관가는길,5,5,126.8541682,37.50725477,10
도선사,5,5,126.9282192,37.7738585,10
도선재,9,9,127.4853054,37.71453481,18
도스타코스 강남역점,4,4,127.0242654,37.50285078,8
도스타코스 서울대입구역점,4,4,126.9528864,37.47914018,8
도식화,8,8,126.9217918,37.5497804,16
도어투성수,5,5,127.0535944,37.5428204,10
도원대중사우나,3,5,126.9572296,37.53950553,8
도이창카페 융건릉점,5,5,126.9892982,37.20637843,10
도이창커피농장,10,10,127.0125396,37.28432585,20
도자기카페 이클림,10,10,127.4927269,37.68571273,20
도제 강남점,5,5,127.0043249,37.50531835,10
도조 AK플라자 AKTown점,5,5,127.000575,37.26521905,10
도축장직영 축산물판매장,4,4,127.2192921,37.92719293,8
도쿄등심,2,2,127.0612949,37.2746026,4
도쿄빙수 건대점,5,5,127.0701061,37.54304241,10
도쿄빙수 성신여대점,5,5,127.0181574,37.5919931,10
도쿄스테이크 건대점,4,4,127.0706221,37.54313941,8
도쿄스테이크 서울스퀘어점,4,5,126.9737483,37.55551931,9
도토리,10,10,126.9727972,37.5319093,20
도토리브라더스,4,4,126.9692595,37.57291466,8
도토리숲 아이파크몰점,5,5,126.9642363,37.52890128,10
도토리캐리커쳐,5,5,126.92556,37.56141471,10
도토리편백집 대학로점,9,10,127.0010733,37.58391079,19
도톰카츠 송도점,5,5,126.6363194,37.39886213,10
도톰카츠 영종점,5,5,126.5595135,37.48578699,10
도트블랭킷,11,13,126.9840968,37.57702613,24
도프레코드,5,5,126.9373584,37.54751916,10
도프커피,9,9,127.5914914,37.48298492,18
도피오커피,3,4,128.9467287,35.1731997,7
도화서,3,3,126.9911396,37.56544367,6
도화아파트먼트,3,4,126.9494901,37.53954212,7
독립문,11,12,126.9595426,37.57245042,23
독립문역 3호선,4,4,126.9579137,37.57446628,8
독산성 세마대,8,8,127.0167343,37.18134288,16
독산역 1호선,11,10,126.8894779,37.46597377,21
독일주택,4,3,127.0005208,37.58299899,7
돈가 대박집 부천점,5,5,126.7791042,37.48624845,10
돈가스온기,4,4,126.7553518,37.49010481,8
돈가쓰살롱,1,1,126.9708103,37.57871746,2
돈까스상회 수원인계점,4,4,127.033897,37.26315081,8
돈까스의집,4,3,127.0907109,37.50703515,7
돈까스잔치 동빙고점,3,4,126.9963937,37.52123731,7
돈까스잔치 마성점,3,3,127.1921835,37.27846152,6
돈까스잔치 마성점 주차장,2,4,127.1922266,37.27856057,6
돈까스클럽 양주본점,6,6,127.0894487,37.7876816,12
돈까스클럽 진건점,5,5,127.1710272,37.65030137,10
돈덩어리,4,4,127.3216409,37.54868707,8
돈박,4,4,126.959191,37.57372971,8
돈부리파스타 송리단길점,8,8,127.109547,37.50964021,16
돈부리파스타 익선점,4,4,126.9902127,37.5734994,8
돈사돈 강동직영점,4,4,127.1242734,37.54182653,8
돈수백 홍대직영점,5,5,126.924526,37.55636667,10
돈암동거리,5,4,127.0187145,37.59232458,9
돈앤까,4,4,126.6256412,37.47213415,8
돈의문박물관마을,14,14,126.9685367,37.56880593,28
돈주는남자 본점,5,5,126.9211128,37.55193513,10
돈짝,5,5,127.1265349,36.99381911,10
돈짱,4,5,126.4634262,33.50294148,9
돈참 오천점,5,5,127.4972566,34.93736995,10
돈치킨,2,2,126.9170024,33.44977355,4
돈키호텔,4,4,126.9254556,37.39772743,8
돈타래게장정식,3,2,126.699598,37.47291836,5
돈통마늘보쌈 남양주덕소점,4,3,127.2213971,37.57939282,7
돌다리곱창골목,5,5,127.1413374,37.59961875,10
돌담병원,3,4,127.3234087,38.07180735,7
돌담집,8,8,127.1005041,37.73118317,16
돌체레스토,5,5,127.0595044,37.16962531,10
돌체파르니엔펜션,7,8,127.4816534,37.53123297,15
돌황소곱창,5,5,126.9109257,37.54980513,10
돗가비불쭈꾸미,3,4,127.6027419,37.51572781,7
동경규동 별내점,3,3,127.1255223,37.65757363,6
동관왕묘,5,7,127.0182569,37.57312628,12
동교로,3,3,126.9177232,37.55528093,6
동구릉,25,26,127.1320504,37.61942243,51
동국대학교 서울캠퍼스,3,3,127.000885,37.55804592,6
동국파전,4,4,126.9976367,37.56159853,8
동궁과월지,8,8,129.2269755,35.83477626,16
동기간,6,7,127.5491043,37.85527196,13
동네골목길관광코스 10코스(종로5.6가동),3,4,127.0065111,37.57124984,7
동대구역,184,183,128.6283938,35.87932399,367
동대구터미널,12,13,128.6303085,35.87798596,25
동대닭한마리 본점,7,7,126.997424,37.56099305,14
동대문 문구완구시장,11,13,127.0144485,37.57123112,24
동대문디자인플라자,132,130,127.009911,37.56718431,262
동대문디자인플라자 디자인전시관,10,10,127.0095397,37.56679511,20
동대문디자인플라자(DDP,4,4,127.0115364,37.56711569,8
동대문디자인플라자(DDP) 동대문역사문화공원,24,24,127.0108437,37.56720225,48
동대문디자인플라자(DDP) 어울림광장,4,4,127.0099065,37.56718792,8
동대문역 1호선,3,3,127.0106338,37.57166941,6
동대문역 4호선,10,10,127.0093138,37.57090728,20
동대문역사문화공원 동대문운동장기념관,3,4,127.0111607,37.5678149,7
동대문역사문화공원역 4호선,3,3,127.0079152,37.56514371,6
동대문엽기떡볶이 본점 홀매장,3,4,127.0155522,37.56609891,7
동대문엽기떡볶이 충주성서점,5,5,127.9322868,36.9700158,10
동대문엽기떡볶이 평촌점,5,5,126.9642646,37.39356929,10
동대문종합시장,29,24,127.0076181,37.57042086,53
동대문종합시장 D동상가,4,4,127.0073487,37.57065514,8
동대문종합시장 먹거리장터,9,9,127.0066843,37.57083537,18
동대문종합시장 악세서리부자재시장,14,13,127.0082293,37.57010907,27
동대문크레페,5,5,127.0073958,37.56632224,10
동대입구역 3호선,5,5,127.005316,37.55905582,10
동동국수 본점,41,43,127.335735,37.34960035,84
동동국수 여주점,3,3,127.602926,37.26400278,6
동동국수집,8,8,127.2365997,37.55712861,16
동두천 치유센터,4,4,127.1401547,37.89057514,8
동두천옹심이메밀칼국수,4,5,127.0558864,37.88943444,9
동두천유아숲체험원,5,5,127.1407077,37.88967353,10
동두천자연휴양림,15,15,127.1371931,37.88989751,30
동래별장,4,5,127.1088126,37.51407653,9
동래복국 동대문점,4,4,127.0101108,37.57175415,8
"동막골 계곡, 힐링야영 축제",5,5,126.4746942,33.22752479,10
동막골숯불닭갈비,10,10,127.0831711,38.08788261,20
동막골유황천,5,4,127.0812168,38.08946238,9
동막골응회암,3,3,127.111187,38.09664967,6
동막해수욕장,3,3,126.5213197,33.51796837,6
동묘백숙닭국수,5,5,127.0188502,37.5736776,10
동묘벼룩시장,7,8,127.0176683,37.57313826,15
동묘시장,37,36,127.0180892,37.57260013,73
동방명주 충무로점,4,4,126.9924033,37.5608667,8
동북각루,14,14,127.0181652,37.28762292,28
동빙고,4,5,126.9823266,37.5179636,9
동사지5층석탑,5,5,127.1858932,37.51686358,10
동서울고속주유소,5,5,127.0680464,37.5975358,10
동서울종합터미널,140,132,127.0785719,37.40859431,272
동순원 성환본점,4,4,127.1298094,36.91698967,8
동숭동1-77,3,3,127.0035207,37.5818179,6
동아펜션,5,5,127.4568247,37.58648661,10
동암역 1호선,8,8,126.7028898,37.47069579,16
동원집,6,6,126.8671644,37.72756302,12
동이손만두,9,9,127.1584181,37.77371261,18
동이집,4,3,126.6733053,37.41443335,7
동인동,3,2,126.8030813,37.55908544,5
동인천 개항거리(개항지+일본풍거리등),4,5,127.7770612,34.69509024,9
동인천 중앙시장 / 인천둘레길12코스,2,2,126.6338126,37.4757818,4
동인천역 1호선,18,15,126.6326161,37.47540327,33
동작구민체육센터,3,3,126.9167674,37.4947185,6
동작역 4호선,5,5,126.9803148,37.50297958,10
동작역 9호선,5,5,126.9785461,37.50274411,10
동작역.국립현충원,5,5,126.9835746,37.52179845,10
"동장대,연무장",5,5,127.0229724,37.2883361,10
동천역 신분당선,6,6,127.1028704,37.33784291,12
동춘서커스 상설공연장,18,20,126.5698347,37.28350345,38
동탄 남광장,5,5,127.0720864,37.20107321,10
동탄센트럴파크,14,14,126.9139949,36.77810395,28
동탄센트럴파크오피스텔,10,10,127.0618997,37.20874962,20
동탄역,37,38,127.0956455,37.20015548,75
동탄호수공원,28,28,127.1045221,37.16783439,56
동탄호수공원 유아숲체험원,3,4,127.102992,37.1719968,7
동하돼지불백,5,5,127.4333856,37.75248748,10
동해바다회해물수산 13호곤지암점,4,4,127.3355717,37.3479177,8
동해반점,4,4,126.906366,37.48938396,8
동해수산,5,5,127.0647924,37.17014244,10
동해수산시장,5,5,126.9909213,37.57390761,10
동해역,8,8,129.1237942,37.49819799,16
동해활어,2,2,126.9939511,37.28562385,4
동해횟집,5,5,127.2096804,37.23180471,10
동호주유소,2,3,127.9689459,37.0253457,5
동화가든 본점,3,6,128.9146602,37.79115937,9
동화카라반캠핑장,2,3,127.5087514,37.8531378,5
동화힐링캠프,4,4,126.8410134,37.89224589,8
동효대교 자전거도로,3,3,127.199439,37.5471439,6
돼지집 본관,5,5,126.8857413,37.43596467,10
두강맥주,4,4,127.0626271,37.28731671,8
두꺼비식당,5,5,126.8681881,37.47507196,10
두껍상회,5,5,128.9473245,37.77256935,10
두껍집,5,5,127.0402425,37.21382556,10
두끼떡볶이 AK&기흥점,3,4,127.1166165,37.27449459,7
두끼떡볶이 건대점,4,5,127.0701308,37.54049617,9
두끼떡볶이 노량진역점,5,5,126.9444369,37.51206289,10
두끼떡볶이 롯데아울렛파주점,4,3,126.6926916,37.71998035,7
두끼떡볶이 숙대점,4,5,126.9680127,37.54481403,9
두끼떡볶이 은행점,5,5,127.427611,36.3280155,10
두끼떡볶이 홈플러스 상암월드컵점,3,4,126.8973858,37.56694372,7
두더지깡,5,5,127.0303693,37.26523407,10
두들리도넛 행리단길점,12,14,127.0127213,37.28514217,26
두레통닭 한라비발디캠퍼스점,2,3,126.7141147,37.36382876,5
두루식당,4,4,127.0485427,37.54907552,8
두리 버섯농원,5,5,126.7322528,37.58760753,10
두리랜드,3,3,126.9503537,37.72478878,6
두리식자재마트 송내점,3,3,126.7643506,37.4835007,6
두머리부엌,2,3,127.326966,37.54603434,5
두메막국수,12,12,127.5061737,37.84705673,24
두메산골,5,5,127.4599934,37.33901891,10
두메풀밭,5,5,126.846019,37.65743901,10
두물길한정식,3,3,127.3226603,37.54154841,6
두물머리,186,191,127.3109595,37.54312781,377
두물머리 공영주차장,10,8,127.3169134,37.53677427,18
두물머리 물래길 1코스,8,9,127.319488,37.54165795,17
두물머리나루터,23,24,127.3156892,37.53274469,47
두물머리밥상,2,3,127.3222289,37.542283,5
두물머리연핫도그,52,52,127.3168201,37.53477341,104
두물머리자전거대여점,3,4,127.32004,37.54373955,7
두부공방,9,9,127.1845378,37.47721336,18
두부마을,9,8,126.9586076,37.58751091,17
두부마을 평내점,4,4,127.2310466,37.64369761,8
두부만드는집,3,2,127.1877483,37.47713351,5
두산벤처다임,3,3,126.97297,37.39129021,6
두웅둥,5,5,126.782117,37.67019075,10
두원빌딩,3,3,127.0192481,37.51860487,6
두유라이크쿠키,1,2,127.0144456,37.28548257,3
두정역 1호선,17,18,127.1490808,36.83359903,35
두지리강촌매운탕,4,4,126.8940967,37.96316907,8
두지리매운탕,14,14,126.8938151,37.9643112,28
두타,8,6,127.0087386,37.56901523,14
두타.밀리오레,5,5,127.0084776,37.568063,10
두타몰,19,17,127.0087386,37.56901523,36
두향,5,5,127.3211966,37.01678181,10
둔산공원시외버스승차장,5,5,127.1293009,35.96091895,10
둘둘치킨 호계점,4,4,126.961946,37.36473037,8
둘레길보리밥,3,3,127.1011162,37.24130362,6
둘레길숯불닭갈비,16,16,127.518129,37.8188808,32
둘리뮤지엄,1,2,127.0276366,37.65242229,3
둥근상시골집,5,5,126.9507988,37.31072388,10
뒷말어린이공원,4,3,127.0336273,37.66372626,7
듀자미,7,7,127.0226011,37.5193431,14
듀크하우스,2,2,127.3761935,37.69823399,4
드라마 아스달 연대기 오산세트장,17,17,127.0639085,37.17953192,34
드라마 촬영지(그해 우리는),1,1,127.0108806,37.2859588,2
드라이브인 솔무인텔,1,3,127.1567406,37.7743248,4
드로잉키즈,5,5,126.9706069,37.55467884,10
드론카페,3,3,127.3201255,37.5440613,6
드롭탑 시흥배곧점,4,4,126.7253787,37.37858358,8
드림게스트하우스,10,10,126.9783834,37.55716727,20
드림닭갈비,4,4,127.4191541,37.73560806,8
드림무인텔 1호점,5,5,127.1576446,37.77401096,10
드림보컬 실용음악아카데미 목동캠퍼스,3,3,126.8754156,37.52473963,6
드림아트센터,5,5,127.0032946,37.58331312,10
드림코인노래방,3,3,126.9855835,37.56943994,6
드림파크야생화공원,5,5,126.6534889,37.57542303,10
드림하우스오피스텔,4,4,127.1286777,37.53809347,8
드메인,2,4,126.8392731,37.63881391,6
드방르파크,3,4,126.7252579,37.5056044,7
드뷔시펜션,3,4,127.2629613,38.0782195,7
드파운드 쇼룸 한남점,4,4,127.0008373,37.5349398,8
드파운드 합정점,5,5,126.9156935,37.54864995,10
든든,5,5,127.2022732,37.23382512,10
들꽃가든,5,5,127.6653077,37.6233005,10
들꽃수목원,7,9,127.862022,36.97265536,16
들밥,8,8,127.4876473,37.8453258,16
들밥 이천점,3,3,127.4337833,37.27888597,6
들밥나들이 본점,5,5,127.0564333,37.44348665,10
등나무가,8,8,127.383198,37.69721946,16
등대해수욕장,10,10,128.598354,38.21459018,20
등산로가든,4,3,127.3256668,38.06831457,7
등촌 최월선칼국수,4,4,126.8566988,37.55603533,8
등촌샤브칼국수 구로점,5,5,126.8889857,37.49457312,10
등촌샤브칼국수 구리점,4,4,127.1407514,37.60114033,8
등촌샤브칼국수 구운점,5,5,126.9715776,37.27447654,10
등촌샤브칼국수 대학로점,5,5,127.0035209,37.5809717,10
등촌샤브칼국수 비전점,5,5,127.1146575,36.99890517,10
등촌샤브칼국수 상동점,2,3,126.7506073,37.50399288,5
등촌샤브칼국수 안국역점,9,9,126.9861706,37.5779454,18
등촌샤브칼국수 일산본점,4,4,126.7753074,37.66783093,8
디델리,5,5,126.7527291,37.48990113,10
디도재즈라운지,5,5,127.0866479,37.53797141,10
디라이프 스타일키친 잠실 롯데월드몰점,5,5,127.1035016,37.51369837,10
디라이프스타일 키친 광화문점,5,5,126.9782579,37.5684225,10
디럭스상회,6,6,126.892843,37.51346986,12
디몰토,5,5,126.808973,37.52511757,10
디뮤지엄,24,25,127.0442167,37.54373339,49
디벙크,3,3,126.9151172,37.54790171,6
디어드라세나 쇼룸,3,3,127.0548763,37.54269818,6
디어스 명동,14,14,126.9912941,37.56080896,28
디에이스호텔,2,2,127.0540619,37.50695309,4
디오디아2.0,5,5,127.0356646,37.48235358,10
디오르펜션,7,10,127.3634229,37.75102296,17
디원골프연습장,5,5,127.258918,37.6535325,10
디저트39 동탄반송점,3,3,127.0724681,37.19967455,6
디저트39 부천시청점,5,5,126.7615299,37.50300181,10
디저트39 수원나혜석거리점,10,10,127.0345684,37.26446163,20
디저트39 월미도점,8,8,126.5988107,37.47550416,16
디저트39 하남감일점,4,5,127.1610082,37.50436175,9
디지털미디어시티역 공항철도,4,4,126.8978819,37.57752092,8
디초콜릿커피 곤지암리조트점,5,5,127.2944424,37.33734825,10
디큐브아트센터,5,5,126.8895885,37.50912673,10
디토 서초점,5,5,127.0043328,37.48568,10
디팰리스웨딩컨벤션,3,3,126.681618,37.4645748,6
디폴트밸류,7,8,126.9273923,37.56614067,15
디플랫 성수,5,5,127.0590007,37.54115097,10
딘딘향 당산역점,5,5,126.9005094,37.53323284,10
딘타이펑 강남점,5,5,127.0256177,37.49851846,10
딘타이펑 명동점,12,12,126.9842625,37.5643951,24
딤딤섬 명동점,2,3,126.9828864,37.56341012,5
딤딤섬 센트럴시티점,5,5,127.0034607,37.50317038,10
딤딤섬 파르나스몰점,5,5,127.060527,37.50879972,10
딤섬점방,10,10,126.7681495,37.66061465,20
딤타오 청라점,4,4,126.6306737,37.53259994,8
딥스테이션,5,5,127.1992079,37.28088992,10
딥티크 가로수길 플래그십스토어,3,4,127.0229743,37.51889072,7
따봉브라질,4,4,126.9945286,37.53331427,8
따오기아동문화관,5,5,126.8461768,37.37795182,10
딱좋아고기 동탄라크몽점,5,5,127.1055927,37.166945,10
딴따라오뎅,2,2,126.9842217,37.56466089,4
딸기핑크게스트하우스,1,4,126.9248981,37.56004297,5
딸보치킨,2,2,127.0701565,37.14585857,4
딸부자네불백,9,9,127.0306003,37.49568451,18
땀땀,9,10,127.0279785,37.50040283,19
땅코참숯구이 본점,5,5,127.0329901,37.56068574,10
땡쓰오트 안국,7,7,126.9846036,37.57879034,14
땡큐도그애견펜션,5,5,127.4692386,37.68746271,10
떡가게종춘 익선점,1,1,126.9895992,37.57285333,2
떡도리탕 강남점,3,4,127.0280781,37.50050011,7
떡볶이샵 신목점,4,4,126.8705495,37.53613025,8
떼루아와인아울렛,2,3,126.7797164,37.60261884,5
또보겠지떡볶이집 몽글몽글청계점,4,4,126.9872429,37.56965006,8
또보겠지떡볶이집 호호시스터점,15,15,126.9168293,37.54895169,30
또뽀끼야 본점,2,3,127.4198024,37.73711217,5
또순이네,1,1,126.8953309,37.53574937,2
또순이순대 본점,5,5,126.9287604,37.48326192,10
또오리,9,9,126.8778632,37.64507919,18
또잇카페 배곧점,4,5,126.7078504,37.36013187,9
뚜레쥬르 가평조은점,5,5,127.5163156,37.82398813,10
뚜레쥬르 수지구청역점,4,4,127.0935212,37.32243582,8
뚜레쥬르 제일제당센터점,5,5,127.0030221,37.5638438,10
뚜레쥬르 카페건대점,5,5,127.0697506,37.54043783,10
뚜레한우,5,5,127.2805258,37.65463635,10
뚜르키즈풀빌라펜션,4,5,127.4538995,37.90460663,9
뚝배기집,4,5,126.9885085,37.56955559,9
뚝섬 자벌레 서울생각마루,4,4,127.0653025,37.52994462,8
뚝섬미술관,5,7,127.0483423,37.54719432,12
뚝섬역 2호선,22,22,127.0473873,37.54724155,44
뚝섬유원지,5,5,128.1399266,35.18010771,10
뚝섬유원지역 7호선,16,16,127.0667962,37.53155838,32
뚝섬한강공원,63,65,127.0689211,37.52929744,128
뚱뚱이할머니집,3,3,127.0058447,37.56040909,6
뚱보집 경기평택역점,4,4,127.091489,36.99337733,8
뚱보할머니분식,4,5,127.0478514,37.74889587,9
뚱오리,3,2,126.697665,37.71583793,5
뚱이등갈비,5,5,126.7502847,37.6687906,10
뜰7커피,4,5,127.0177551,37.25102989,9
뜰안에밥상,3,4,127.156797,37.77198493,7
띠오데산타바바라 멕시칸타코&그릴,8,9,126.6445511,37.39199168,17
띵굴스토어 성수점,6,6,127.0568386,37.54140882,12
라공방 건대스타시티점,5,5,127.0727665,37.53857995,10
라공방 서울대직영점,3,3,126.9521126,37.47986428,6
라그랑자트,3,3,127.0429599,37.52264232,6
라그레이,4,4,126.8778133,37.46120675,8
라까사호텔 광명,4,4,126.8819768,37.42123476,8
라뉘호텔,5,5,126.9361492,37.55354079,10
라디오엠 삼청점,1,3,126.9812569,37.57994133,4
라뜰리에 빵카페,7,7,127.1644449,37.79355975,14
라띠에라,9,9,126.8740436,37.4579177,18
라라맥주,4,4,127.0008469,37.58398557,8
라라면가,5,5,127.0196562,37.5909387,10
라라브레드 송파점,5,5,127.1091115,37.51114619,10
라라식탁,5,5,126.8619576,37.38226377,10
라라코스트 고양화정점,5,5,126.8307057,37.63169316,10
라라코스트 롯데월드점,3,3,127.0981404,37.51131078,6
라라코인노래연습장,1,1,127.0274707,37.50038493,2
라리아호텔,5,5,127.0031568,37.26782302,10
라마노피자,4,5,126.8992583,37.48425679,9
라마다 서울동대문,10,10,127.0026984,37.56589447,20
라마다바이윈덤서울동대문,5,5,127.0027958,37.56589807,10
라마다서울신도림호텔,5,5,126.8854081,37.50623232,10
라마다송도,5,5,128.7748572,37.27106606,10
라마다앙코르 평택호텔,7,7,126.8430045,36.97615934,14
라마다앙코르바이윈덤 김포한강호텔,20,20,126.7858922,37.60122106,40
라마다인천호텔,5,5,126.7354821,37.40028516,10
라마다프라자 수원호텔,8,8,127.03244,37.27773006,16
라마다호텔앤스위트 서울남대문,5,5,126.9718858,37.56048878,10
라메르베이커리카페,4,4,126.6710511,37.57108906,8
라무라,3,4,126.9085968,37.54978894,7
라무진 라페스타점,5,5,126.7665867,37.66277572,10
라무진 여의도점,5,5,126.9292823,37.51970251,10
라미르,4,4,127.3100904,37.19239695,8
라미방마라탕 안양점,4,4,126.9226659,37.40015749,8
라미옥,5,5,127.1242808,37.51285572,10
라바타운,5,5,126.9716103,37.57071322,10
라밥 이태원점,4,4,126.9971805,37.53455955,8
라베니체 마치에비뉴 1차,4,4,126.6784692,37.64202972,8
라베니체 마치에비뉴 2차,4,4,126.6797465,37.6401123,8
라베니체1구역 공영주차장,5,6,126.6789528,37.6420878,11
라베니체마치에비뉴 5차,4,4,126.678852,37.64049549,8
라베니체마치에비뉴 주차장,8,9,126.6783061,37.6415004,17
라벤따나,5,5,126.9835987,37.5706337,10
라보나 쿠치나 보정카페거리점,5,5,127.1108084,37.32116666,10
라뷰베이커리,9,9,127.4238612,37.50341371,18
라비돌리조트컨트리클럽,6,7,126.9834101,37.19042192,13
라비돌웨딩 강남,4,4,127.0329978,37.49609472,8
라비타호텔,4,4,127.0568686,37.52137504,8
라빈리커스토어,5,7,126.8263412,37.60272188,12
라성보석사우나,4,4,127.0578146,37.54517903,8
라스블랑카스,4,4,127.3716469,37.68944411,8
라스커피,5,5,126.729981,37.45655008,10
라씨에트,4,4,126.9987063,37.4976923,8
라오삐약,5,5,126.9044286,37.55272289,10
라온드뷰,3,3,127.3470177,37.60553617,6
라온빌스파앤독채펜션,5,5,127.5092313,37.84956258,10
라온숨,8,10,127.3439092,37.61616968,18
라온아트홀,15,15,127.0028032,37.58185289,30
라온캠프닉,4,5,126.8261931,37.22077811,9
라우더 커피바,5,5,126.9574722,37.47889684,10
라운드앤드,4,4,126.9723637,37.56606066,8
라운지11,9,9,126.9136993,37.13967115,18
라운지디,4,3,127.0200799,37.43130047,7
라이브7080노래극장,2,2,126.9911482,37.53094623,4
라이브러리스테이 지지향,19,19,126.6866875,37.70826455,38
라이엇PC방,4,5,126.9814402,37.57096024,9
라이즈앤드밀크코코아,5,5,126.9223018,37.55339554,10
라이즈오토그래프컬렉션,22,22,126.9212766,37.55441659,44
라이크시즌,4,4,126.629282,37.47475674,8
라이트레인,4,4,127.0658318,37.54123206,8
라인프렌즈 월드 팝업스토어,12,13,127.0501271,37.54252459,25
라인프렌즈 플래그십스토어 강남점,2,2,127.0005707,37.45248774,4
라인프렌즈 플래그십스토어 홍대점,5,4,126.9216498,37.55574491,9
라임모텔,2,2,127.0011488,37.26867724,4
라임오렌지펜션,10,8,127.4563545,37.58477115,18
라칸티나,3,4,126.9799417,37.56621445,7
라크드미엘,5,5,127.1039085,37.16701857,10
라크몽,5,5,127.1051946,37.16725531,10
라티오커피,3,3,126.3765205,33.48341383,6
라파즈,5,5,127.0557361,37.29399415,10
라팡드포레펜션,8,8,127.6724838,37.61111472,16
라페스타,29,29,126.7329764,37.06920344,58
라페스타문화의거리,3,4,126.7690229,37.66075872,7
라퓨타리조트,1,5,127.5324862,37.77670634,6
라프레플루트,4,4,127.0394366,37.54724988,8
라프터커피바,3,4,127.014886,37.2888542,7
라플란드 원흥점,5,5,126.8709125,37.65095297,10
라플랑끄,4,4,126.993542,37.53334305,8
라플레이스,5,5,127.0534682,37.50549013,10
라피스키친,5,5,127.1996981,37.89780216,10
라피유,11,13,127.103673,38.03522828,24
라홍방마라탕 광교점,4,4,127.050156,37.29272528,8
라홍방마라탕 청당점,4,4,127.1527716,36.78358091,8
락떼스피릿,8,9,126.9039262,37.55618231,17
락모텔,4,3,126.6834127,37.79794676,7
락원,5,5,126.6707134,37.64744664,10
락휴코인노래연습장 구로디지털단지점,5,4,126.9016223,37.48355059,9
락휴코인노래연습장 서울신사역점,5,5,127.0226052,37.51789068,10
락휴코인노래연습장 서울홍익대점,4,4,126.9226488,37.55498512,8
랑데자뷰 강남점,5,5,127.0279432,37.50268418,10
랑데자뷰 부천점,5,5,126.7809966,37.48559964,10
랑데자뷰 시흥거북섬점,9,9,126.6824959,37.32303073,18
래격마라탕 중산점,5,5,126.7801299,37.69289438,10
래미안갤러리,3,4,127.1201403,37.47926869,7
래미안광교아파트,14,14,127.0613323,37.29124502,28
래미안금광아파트,5,5,127.17284,37.45020884,10
래미안어반비스타아파트,4,4,126.7630857,37.4809213,8
래미안영통마크원1단지아파트,6,6,127.0431732,37.24613158,12
래미안장위퍼스트하이아파트 정문,4,4,127.0513182,37.6210102,8
랜드마크송도스테이,5,5,126.6278968,37.40520611,10
랜디스도넛 신사가로수길점,4,4,127.0240151,37.51931399,8
랜디스도넛 안국점,25,27,126.9857587,37.57717771,52
랜디스도넛 연남점,7,8,126.9241219,37.56202106,15
램브란트 강남N점,2,4,127.0323674,37.49993228,6
램파트호텔,4,4,126.9713494,37.28154064,8
랩오브 파리바게뜨,9,9,127.1116845,37.3955141,18
랫댓,4,4,126.9241673,37.56191838,8
랭커PC카페 교대점,1,1,127.0156955,37.49362863,2
러브이즈,3,4,127.1395109,37.43624031,7
러브컨템포러리아트 서울,4,3,126.9840259,37.58061928,7
러빙베이,4,4,126.8941142,37.51443959,8
러셔스 스쿱스,4,4,127.0021511,37.58270164,8
러쉬 강남역점,12,12,127.0256672,37.50103766,24
러쉬 롯데백화점 본점,5,5,126.9815281,37.5634856,10
러쉬 명동역점,5,5,126.9852772,37.56175711,10
러쉬코리아 20주년 쇼케이스,5,5,129.0094283,35.09630013,10
러스트커피바,5,5,128.9178304,37.79562367,10
러시아 케이크,10,10,127.0058858,37.56582948,20
러시안케이크,5,5,126.9946125,37.56110468,10
럭키마트 의정부점,3,3,127.0479463,37.71301557,6
럭키차이나,13,15,126.6190607,37.47503959,28
럭키팩토리,5,5,127.0003612,37.58349543,10
런던베이글뮤지엄 도산점,27,29,127.0364388,37.52606833,56
런던베이글뮤지엄 안국점,93,97,126.9861998,37.57916896,190
레고,3,4,127.1040387,37.51364114,7
레고랜드코리아리조트,7,7,127.6968924,37.8842911,14
레끄레오 보드게임카페,4,4,126.9231144,37.55561973,8
레드83,5,5,127.1972551,37.59610758,10
레드브릭커피하우스,13,13,127.0107445,37.28555144,26
레드브릿지,10,11,126.9282192,37.7738585,21
레드블럭,3,3,126.7612454,37.71612078,6
레드애플 청라센트럴점,4,4,126.6502576,37.53193516,8
레드인 거북섬점,3,4,126.6827816,37.32272155,7
레드컨테이너 강남점,2,4,127.0273318,37.50074176,6
레드파이프,5,4,126.6928259,37.72590907,9
레드펜션 신관,5,5,127.4664433,37.81514705,10
레몬그라스 타이,5,5,127.0401364,37.51653091,10
레몬하우스,5,5,126.9859309,35.32783715,10
레솔레파크,14,14,126.9531429,37.30707384,28
레스케이프호텔,43,44,126.9794873,37.55968215,87
레스트,5,5,126.6244312,37.23228686,10
레스트호텔,5,5,126.6851359,37.63990877,10
레스피레,5,5,126.9065542,37.55431035,10
레이저엑스,5,5,126.9257693,37.55349147,10
레이지버거클럽 원흥점,7,7,126.8634918,37.64141222,14
레이지하우스,5,5,127.0802442,37.25227991,10
레이크 삼청,3,4,126.9802227,37.57787068,7
레이크꼬모 동탄,18,18,127.1061771,37.17178855,36
레이크스토어,4,4,126.9352268,37.77662311,8
레인보우호텔,4,4,127.1524246,37.77409441,8
레인하우스,5,5,127.3265574,37.57531233,10
레저친구,5,5,127.5305681,37.7999422,10
레저캠프,7,9,127.4893284,37.71232343,16
레전드이스케이프 이천점,4,4,127.4429901,37.28065394,8
레종데트르,4,4,126.9688942,37.58017388,8
레코드피자,8,7,126.9566021,37.55072258,15
레트로카페트레이더,5,5,127.0189728,37.48543709,10
레페토 로데오점,5,4,127.0390295,37.52611435,9
렉시호텔,10,10,127.033984,37.49879836,20
렌위치,5,5,126.9257206,37.52494776,10
렛츠런파크 (경마공원),5,5,126.5296188,33.51435052,10
렛츠런파크 서울,5,5,127.2009876,37.29710918,10
렛츠런파크서울,41,42,127.015826,37.44760949,83
렛츠런파크서울 포니랜드,3,3,127.0159977,37.44699678,6
로그,4,4,126.9982169,37.58310169,8
로니로티 노원점,5,5,127.0618876,37.65650336,10
로데오모텔,3,3,127.0882271,37.5798666,6
로데오유황24시사우나,3,3,127.1256794,37.64590034,6
로뎀식당,4,4,127.2519578,37.33645522,8
로뎀해장국 가평점,5,5,127.5143275,37.83078997,10
로도스피자,10,9,126.881801,37.4181459,19
로또휴게실,4,4,127.1042825,37.2564276,8
로라멘,5,5,126.8936895,37.51399591,10
로마경양식,15,14,127.0293065,37.27493886,29
로마옥,4,4,127.0340906,37.48696541,8
로만바스,4,4,127.1570105,37.23308014,8
로매지크 성수점,4,4,127.0407832,37.54715933,8
로미스토리 홍대플래그쉽스토어,3,3,126.9216082,37.55005418,6
로바타탄요 압구정,4,4,127.0277144,37.52308838,8
로봇김밥 김포공항점,4,4,126.8032148,37.55870274,8
로블랜드 전망대카페,5,5,126.6540136,37.41989718,10
로슈아커피,3,4,127.0839614,37.78515573,7
로스트인홍콩,3,2,126.9712929,37.53061781,5
로스하우스,4,4,127.0144519,37.2835183,8
로쏘1924,3,4,126.9217076,37.55452409,7
로얄면역공방사우나,3,3,126.9313174,37.52085699,6
로얄엑스 클럽라운지앤베이커리,5,5,126.8867042,37.17117645,10
로얄엑스 플래그쉽 화성,5,5,126.8867852,37.17118734,10
로얄엠포리움호텔,2,2,126.5782857,37.49187237,4
로얄인디안레스토랑 건대점,4,4,127.0664569,37.5418552,8
로와이드,7,7,127.0410433,37.54693399,14
로우드,3,5,127.4911954,37.43454159,8
로우앤슬로우,5,6,126.9942185,37.53401163,11
로우키,8,8,127.0515767,37.54419082,16
로우키 송정점,4,4,127.0652019,37.549436,8
로우파이브,4,4,127.0117163,37.28368079,8
로운샤브샤브 청량리점,5,5,127.0477222,37.58082515,10
로이넷호텔 서울마포,18,18,126.9482892,37.54184816,36
로잔네일,5,5,126.9304336,37.39554548,10
로제펜션,14,14,127.4676727,37.81488991,28
로즈마리모텔,4,4,127.0845697,37.51121046,8
로충칭마라탕 궁동점,4,4,127.3499989,36.36299211,8
로컬릿,4,3,127.0147436,37.54093954,7
로컬빌라베이글,5,5,126.9914239,37.53414661,10
로쿠커피,3,4,127.0734821,37.55403614,7
로파 서울,2,2,126.9625663,37.52477057,4
로프,5,5,127.5815081,37.21492431,10
로프트가든344,4,5,126.8754618,37.52412339,9
로하스캠핑,5,5,127.0252446,38.13242792,10
로향양꼬치 서울대2호점,5,5,126.9590648,37.47756391,10
로향양꼬치 서울대본점,5,5,126.9546722,37.4799635,10
록키즈버거,4,4,127.050631,37.08037461,8
론스타호텔,5,5,127.051199,37.65373346,10
롤리폴리꼬또,5,5,127.0423245,37.51128631,10
롤링파스타 대학로점,5,5,127.0035322,37.5816078,10
롤링파스타 인천신포시장점,5,5,126.6262765,37.47168927,10
롤링핀 인천시청역점,4,4,126.7018522,37.45300817,8
롤링힐스호텔,50,52,126.8387513,37.19017639,102
롤링힐스호텔 블루사파이어,4,4,126.8386341,37.19020146,8
롤파크,5,5,126.9813904,37.5711116,10
롬곡,3,3,127.0726392,37.5484775,6
롯데ATM 롯데몰 광명5층 1,4,5,126.8846757,37.42346474,9
롯데렌터카 송파지점,5,5,127.1191059,37.478612,10
롯데리아 가평설악점,3,3,127.4929756,37.67719843,6
롯데리아 김포국제공항국내선청사4층점,8,7,126.8023669,37.55918245,15
롯데리아 남부터미널점,4,4,127.0159289,37.48514921,8
롯데리아 노량진점,4,4,126.9400295,37.51302301,8
롯데리아 동대문역사문화공원역점,3,4,127.0066103,37.56639527,7
롯데리아 동수원점,3,3,127.0333589,37.26485393,6
롯데리아 롯데백인천터미널점,5,5,126.7015261,37.44233307,10
롯데리아 별내신도시점,3,3,127.1254886,37.65777729,6
롯데리아 불광점,4,4,126.9287742,37.61142359,8
롯데리아 서대문역점,3,4,126.9660093,37.56577608,7
롯데리아 서울역사점,10,10,126.9700601,37.55510037,20
롯데리아 수원역사점,5,5,126.9999414,37.26622371,10
롯데리아 수원화서점,5,5,127.0031775,37.27818498,10
롯데리아 안성죽산점,2,2,127.4263131,37.0759892,4
롯데리아 여주점,3,3,127.6369444,37.2958333,6
롯데리아 용산역사점,8,9,126.9642024,37.52889767,17
롯데리아 월드점,4,4,127.0960495,37.51075748,8
롯데리아 인천월미마이랜드점,4,3,126.5961308,37.47141348,7
롯데리아 잠실롯데월드몰B1점,3,3,127.1042023,37.51415276,6
롯데리아 제주공항국내선탑승점,4,4,126.4929232,33.50684518,8
롯데마트 경기양평점,5,3,127.5026112,37.4894782,8
롯데마트 광교점,5,4,127.0494047,37.29071358,9
롯데마트 금천점,8,8,126.8970269,37.45918786,16
롯데마트 덕소점,2,2,127.2146154,37.58475003,4
롯데마트 롯데몰수지점,4,4,127.0821916,37.31216164,8
롯데마트 마석점,5,5,127.3092413,37.65010472,10
롯데마트 맥스 영등포점,10,10,126.9046075,37.52779238,20
롯데마트 부평역점,3,3,126.7229342,37.48987105,6
롯데마트 서울역점,14,14,126.9702125,37.55600861,28
롯데마트 송도점,6,6,126.6432274,37.38822143,12
롯데마트 수원점,5,5,126.9959754,37.26353403,10
롯데마트 영통점,8,8,127.0718022,37.25292507,16
롯데마트 오산점,5,5,127.073028,37.14942053,10
롯데마트 월드타워점,4,4,127.1041472,37.51354013,8
롯데마트 은평점,5,5,126.9180295,37.63716502,10
롯데마트 의왕점,5,5,126.9728959,37.38056621,10
롯데마트 이천점,8,8,127.4546106,37.27419453,16
롯데마트 제타플렉스,13,13,127.0964714,37.51170139,26
롯데마트 중계점,4,4,127.0709694,37.64674601,8
롯데면세점 명동본점,5,5,126.9819805,37.56488086,10
롯데면세점 월드타워점,5,5,127.1018936,37.51321773,10
롯데몰 광명점,39,38,126.8846893,37.42343232,77
롯데몰 김포공항점,65,65,126.8031482,37.56336618,130
롯데몰 수원점,31,31,126.9972989,37.26398819,62
롯데몰송도캐슬파크오피스텔,3,3,126.6415548,37.38518895,6
롯데뮤지엄,4,4,127.1025624,37.51264051,8
롯데백화점 강남점,4,4,127.0532811,37.49695949,8
롯데백화점 건대스타시티점,7,6,127.071408,37.53899524,13
롯데백화점 구리점,9,9,127.1438844,37.60268265,18
롯데백화점 김포공항점,11,12,126.8032405,37.56312216,23
롯데백화점 노원점,4,4,127.061338,37.65507469,8
롯데백화점 동탄점,20,21,127.0979193,37.20070867,41
롯데백화점 명동본점,4,4,127.7307925,37.88010073,8
롯데백화점 본점,64,64,126.9817541,37.5649056,128
"롯데백화점 본점 (Tom ford,Papyrus)",4,4,126.9816722,37.5647103,8
롯데백화점 분당점,13,12,127.1145144,37.37832439,25
롯데백화점 수원점,13,12,126.9985232,37.2644982,25
롯데백화점 영등포점,21,21,126.907292,37.51601481,42
롯데백화점 영등포점 주차장,5,5,126.908545,37.51625996,10
롯데백화점 인천점,8,8,126.7015224,37.44240695,16
롯데백화점 일산점,17,17,126.7721336,37.66047105,34
롯데백화점 잠실점,19,18,127.0985553,37.51201142,37
롯데백화점 중동점,12,11,126.7752042,37.50256911,23
롯데백화점 청량리점,4,2,127.0476837,37.58082967,6
롯데백화점 평촌점,20,18,126.9504657,37.39022152,38
롯데슈퍼 공릉점,9,9,127.0794499,37.62253085,18
롯데슈퍼 춘천점,5,5,127.7285776,37.86029487,10
롯데시네마 가양,5,5,126.8533833,37.56156338,10
롯데시네마 광명아울렛,7,8,126.8841627,37.42499597,15
롯데시네마 도곡,5,5,127.0471053,37.48747451,10
롯데시네마 라페스타,4,4,126.7689241,37.6611946,8
롯데시네마 부천역,4,4,126.7822672,37.4856993,8
롯데시네마 수원,5,5,126.9968659,37.26438104,10
롯데시네마 안산고잔,3,3,126.8287971,37.30886587,6
롯데시네마 에비뉴엘,7,6,126.9818448,37.56429654,13
롯데시네마 월드타워,9,9,127.1050686,37.51401685,18
롯데시네마 청량리,5,5,127.0476087,37.58044048,10
롯데시네마 평촌,5,5,126.9507465,37.39068837,10
롯데시네마 평택비전,4,4,127.1124955,36.99554981,8
롯데시네마 하남미사,8,8,127.2044776,37.55814366,16
롯데시티호텔 구로,4,4,126.8969379,37.48526752,8
롯데시티호텔 마포,19,19,126.9587119,37.55424822,38
롯데시티호텔 명동,15,15,126.9880335,37.56695347,30
롯데아울렛 고양점,7,9,126.8627757,37.62910213,16
롯데아울렛 광교점,15,15,127.0555457,37.28652643,30
롯데아울렛 구리점,11,12,127.1405451,37.61187676,23
롯데아울렛 서울역점,23,22,126.9709538,37.55475265,45
롯데에비뉴엘 본점,5,5,126.9817204,37.56420057,10
롯데에비뉴엘 잠실점,21,21,127.1017077,37.51289804,42
롯데영플라자 본점,4,4,126.9815508,37.56346848,8
롯데우성아파트,4,4,127.0734352,37.64683099,8
롯데월드,158,160,127.0903277,37.51246369,318
롯데월드 민속박물관,10,13,127.0977165,37.51122704,23
롯데월드 샤롯데씨어터,37,39,127.099714,37.51064272,76
롯데월드 어드벤처,32,32,127.0982326,37.51087823,64
롯데월드몰,4,4,129.2033063,35.83811411,8
롯데월드아쿠아리움,23,27,127.1040931,37.51366271,50
롯데월드타워,118,122,127.1025556,37.51260448,240
롯데월드타워 광장,4,5,127.103166,37.152778,9
롯데월드타워 초대형 피카츄,3,3,127.1025556,37.51260448,6
롯데월드타워&롯데월드몰,202,205,127.1040795,37.51365191,407
롯데캐슬캠퍼스타운아파트,5,3,126.6650671,37.38802581,8
롯데콘서트홀,15,15,127.1048853,37.51400079,30
롯데팩토리아울렛 가산점,8,7,126.8848285,37.47934212,15
롯데프리미엄아울렛 기흥점,28,30,127.1209595,37.22503374,58
롯데프리미엄아울렛 이천점,46,46,127.4004753,37.24235547,92
롯데프리미엄아울렛 타임빌라스,41,41,127.0096645,37.37618093,82
롯데프리미엄아울렛 파주점,70,71,126.6926426,37.71811521,141
롯데호텔 서울,24,24,126.9810126,37.56538301,48
롯데호텔 월드점,4,4,127.1004196,37.5114242,8
롯데호텔서울 라세느,3,3,126.9809844,37.56530913,6
롯데호텔월드,39,39,127.1003405,37.51146661,78
롯데호텔월드 라세느,4,4,127.1000203,37.51139931,8
롱브릭스,3,4,127.4039823,37.29885378,7
롱위켄드,5,5,126.9728709,37.57186318,10
루다(luda),4,4,127.3275321,36.62015899,8
루다헤어 화이트점,5,5,126.9683027,37.29752067,10
루미아호텔,3,3,127.0222395,37.57383288,6
루비관광호텔 월미도,6,6,126.5985412,37.47389405,12
루비떡볶이,4,5,127.037626,37.52463536,9
루소홈,11,11,127.0173145,37.28626518,22
루시카토베이크카페 용산아이파크몰,5,5,126.9645565,37.52880497,10
루아르커피바 망원,5,5,126.910526,37.55473689,10
루엔커피로스터스,3,3,126.6319233,37.39343792,6
루오호텔,8,9,128.6881911,35.83974152,17
루지월드 포천 베어스타운,4,3,127.2461507,37.80042233,7
루커피,4,4,127.1881113,37.5515053,8
루트66,5,5,126.9922385,37.53407549,10
루프37.2,3,4,127.3614947,37.05385765,7
루프스테이션 익선,5,5,126.9892787,37.57395342,10
루프탑G길리건스,2,3,126.9214358,37.55260479,5
룩소르호텔,6,6,126.7489195,37.67637664,12
룰루랄라캠핑장,4,4,127.2716478,37.19613428,8
룰루레몬 이태원스토어,4,4,126.9961668,37.53442076,8
륀느펜션,5,5,127.521121,37.89754416,10
류재은베이커리 본점,11,13,126.6872492,37.78852217,24
류재은베이커리 헤이리아트밸리점,4,4,126.697178,37.7869444,8
류타이쿠진,3,3,126.82077,37.48341415,6
르 라보 성수 부티크,9,8,127.0561467,37.54228763,17
르노모텔,22,22,127.0171708,37.27877486,44
르노코리아자동차 지정정비센터 기흥정비,3,3,127.1047414,37.26789927,6
르디쉬,2,2,126.9702014,37.40750433,4
르디투어 광교점,4,4,127.0549824,37.31212334,8
르모브,3,3,126.9638898,37.59527399,6
르몽블랑,3,3,126.984855,37.54487866,6
르미에르더파티 김포점,3,3,126.626813,37.64538064,6
르봉뺑,19,19,127.5100385,37.83281232,38
르빵드파파 행궁점,5,5,127.0136113,37.28663599,10
르쁘띠푸 홍대본점,2,2,126.923256,37.5499111,4
르푸앙,5,5,127.4687077,37.70830241,10
르플로,5,5,126.682197,37.32328763,10
르하임스터디카페 원당점,3,3,126.838859,37.65847818,6
리(Re),5,5,126.7596667,37.71258576,10
리김밥 아모레퍼시픽점,5,5,126.9683906,37.52887724,10
리김밥 압구정본점,3,3,127.0291468,37.52663978,6
리꼬,4,4,127.1831249,37.56897263,8
리네아의가게,1,2,126.9071468,37.55099334,3
리더스모텔,5,5,126.9103341,37.51844266,10
리더스펜션,3,3,127.4890436,37.71316432,6
리드스트리트커피,4,4,127.054489,37.59036014,8
리디자인호텔,19,19,127.1503517,37.27224,38
리띵커피,4,4,126.3153583,36.58514926,8
리메인,3,3,128.2069584,37.12885252,6
리멤버 수원직영점,4,4,127.0034544,37.26812576,8
리미트8호텔,3,3,126.7681888,37.66329154,6
리버레인,27,27,127.397225,37.70715579,54
리버레인 카페,4,3,128.0799814,35.18955476,7
리버레전드키즈,5,5,127.3567096,37.6179371,10
리버모텔,8,8,127.2200001,37.5755536,16
리버빌,9,9,127.4485992,37.70835541,18
리버스PC방,3,3,126.8925351,37.4765995,6
리베라모텔,5,5,127.1314012,37.43291044,10
리베르떼,5,5,126.7563963,37.66600495,10
리베르테,3,3,126.5704201,37.26900164,6
리블럽,5,5,127.0140824,37.28516905,10
리블링스 커피&플라워,5,5,126.9682297,37.55620632,10
리빙파워센터,9,9,127.1142641,37.22343653,18
리사르 명동점,9,9,126.9882063,37.56177095,18
리사르커피로스터스,10,10,127.0484198,37.52708215,20
리숨두부,5,5,127.210311,37.45663538,10
리슨,4,4,126.9183745,37.54751477,8
리앤이라마띠네,5,5,126.9908545,37.56433903,10
리얼월드 성수,1,3,127.0584086,37.54217751,4
리얼케익 안양범계점,4,4,126.9538222,37.3913924,8
리에제와플더뷰,17,18,126.9763608,37.56468841,35
리오모텔,2,3,127.3856198,37.68316361,5
리움 하우스웨딩,6,7,126.6202105,37.47480182,13
리움미술관,29,29,126.9502392,36.82770651,58
리유라멘,5,5,126.863236,37.47781801,10
리춘시장 수원역점,5,5,127.0042526,37.26837802,10
리춘시장 양주옥정점,5,5,127.0933879,37.82086627,10
리치호텔,16,16,126.8196749,37.57746577,32
리케,3,4,126.6196386,37.47477115,7
리케이크,5,5,127.1280548,37.65073966,10
리코드엠,3,3,127.0129548,37.2854539,6
리코퀸노래연습장 고려대점,3,3,127.0297375,37.5868632,6
리타르단도,4,5,127.0544811,37.53908085,9
리틀꼬마김밥 세교점,4,4,127.0505272,37.17474116,8
리틀버틀러,3,3,126.9859623,37.5776012,6
리틀본수원갈비집,5,5,127.0115369,37.29060078,10
리틀쿠바,5,5,126.9365765,37.55676659,10
리펠,9,9,127.2362582,37.55472363,18
리프패럿,5,5,127.1876432,37.55663992,10
리프패럿 용인점,5,5,127.2349791,37.20903102,10
리플로우 북한산점,5,5,126.9504217,37.66353863,10
린궁즈멘관,5,5,126.8991546,37.49075837,10
린치핀,4,5,126.6607196,37.38252441,9
릿지베이커리카페,4,4,126.8105647,37.74511344,8
릿킷티,5,5,126.9541632,37.51179136,10
마가렛 연남,4,5,126.9228063,37.56458985,9
마곡역 5호선,5,5,126.8246969,37.56022864,10
마녀김밥 청담노들섬점,5,5,126.9575405,37.51803297,10
마녀찜닭닭갈비 홍대본점,3,3,126.9217517,37.55139496,6
마담샤브칼국수막국수 송도점,5,5,126.6382032,37.40050866,10
마담파이,4,4,127.1280747,37.65773306,8
마담파이 미사호수공원점,4,4,127.1895267,37.56391336,8
마담파이 팔당점,3,3,127.2370543,37.55309304,6
마들렌,2,2,127.0091442,37.55334146,4
마라889,4,4,127.0075702,37.56734667,8
마라공방 교대점,3,4,127.0114072,37.4912874,7
마라공방 문정점,5,5,127.1221306,37.48507635,10
마라공방 평택역점,5,5,127.0883575,36.99273182,10
마라도해물탕&찜 광교점,4,4,127.045193,37.3008285,8
마로니에공원,85,85,127.0253731,37.47045977,170
마롱리면사무소카페,4,4,126.8201524,37.89713232,8
마롱베이커리&카페,4,4,126.9783307,37.19028414,8
마루산 독채펜션,3,1,127.5092428,37.8506486,4
마루샤브 아차산점,2,2,127.0880113,37.5542929,4
마루심 본점,4,4,127.0104814,37.50189414,8
마루아트홀,10,10,127.0025677,37.58229979,20
마루호텔,19,20,126.9263221,37.39742612,39
마리오아울렛 3관,6,7,126.8851249,37.47848825,13
마리왕 잠실점,3,3,127.1001971,37.51329127,6
마리호텔,11,10,127.2751815,37.61779064,21
마린보이동태해물찜 코다리1번가 오이도점,4,4,126.6901352,37.34528475,8
마미스치킨 성균관대점,4,4,126.9960236,37.5882391,8
마미치킨,8,8,126.7244989,37.49117576,16
마방집,4,4,127.2171573,37.5321777,8
마부 소사8호점,4,4,126.7928699,37.48518136,8
마사타코,3,4,127.0217422,37.52200662,7
마산고속버스터미널,3,3,128.5878745,35.22302306,6
마산역,8,8,128.5770678,35.23609526,16
마석전통민속오일장,5,5,127.304508,37.65314252,10
마스크랩,4,4,126.9250638,37.55960339,8
마스크랩 홍대점,5,5,126.9218408,37.55269245,10
마시안제빵소,4,4,126.4142977,37.4351166,8
마실빌리지펜션,10,10,127.2301857,37.68926719,20
마안산,4,4,126.9497163,36.93066908,8
마약뒷고기,4,5,127.2182706,37.28457579,9
마약떡볶이,5,5,126.9231489,37.40052452,10
마얘,4,4,126.9976342,37.49891766,8
마운틴누크,5,5,127.1082342,37.5106145,10
마음농장위드스테이,10,10,127.3220125,37.5666735,20
마음정원,5,5,127.3232139,37.56808657,10
마이다스리조트 키즈잼,5,5,127.4031943,37.7138135,10
마이다스호텔&리조트,42,42,127.4031945,37.71385315,84
마이다스호텔&리조트 디오니소스레스토랑,4,4,126.5871304,33.5002743,8
마이랜드,34,34,126.5989537,37.47493318,68
마이보스턴,4,4,126.9310643,37.5549615,8
마이시크릿덴,5,5,126.9762193,37.5647965,10
마이아트뮤지엄,19,22,127.0605769,37.50758784,41
마이알레 과천빌리지카페,13,13,127.0239489,37.4466026,26
마이알레 현대프리미엄아울렛 스페이스원점,3,3,127.1524213,37.61625523,6
마이움트라이스타오피스텔,4,4,127.1881384,37.55149805,8
마이포레스트,3,3,127.0451322,37.47241491,6
마일드하이클럽,4,4,127.0354221,37.52660924,8
마일리버거 동탄호수점,4,4,127.0949235,37.16689635,8
마일스톤 커피 한남,5,5,127.0026454,37.53786262,10
마일스톤커피,8,9,127.0243304,37.52185115,17
마장호수,44,51,126.9302204,37.77494176,95
마장호수출렁다리,37,41,126.9281035,37.77602795,78
마전교,5,5,127.002033,37.56963902,10
마차리폐광촌,5,5,128.4570325,37.25609607,10
마초쉐프 건대점,5,5,127.0713002,37.54218755,10
마츠노하나 더현대서울점,5,5,126.9282989,37.52603416,10
마츠루,5,5,126.9861727,37.49314682,10
마카오훠궈,5,5,126.6602322,37.38044526,10
마켓가든,5,5,126.6698615,37.41485627,10
마켓인유 성수점,4,2,127.0618838,37.54249199,6
마켓정 사또왕갈비 논현본점,1,3,127.0227973,37.50969961,4
마코토 청담점,4,4,127.0435853,37.52436121,8
마크,4,4,126.8383392,37.54053068,8
마크69,5,5,127.0399914,37.54787139,10
마크빈제빵소 가평1호점,6,6,127.5125377,37.8255939,12
마트킹 구성점,4,4,127.1065044,37.30285709,8
마포sk허브블루오피스텔,5,5,126.9565197,37.55199853,10
마포갈매기골목,5,5,126.950679,37.54180233,10
마포곱창타운,6,6,126.9225223,37.55906476,12
마포구청역 6호선,4,4,126.9034256,37.56348719,8
마포대교,5,5,126.9365917,37.53348478,10
마포본가 본점,13,15,127.0281331,37.27266732,28
마포새빛문화숲,3,3,126.9196931,37.54405764,6
마포소문난족발,4,5,127.0560138,37.21203868,9
마포양지설렁탕,4,4,126.9505068,37.54202931,8
마포에이트,4,4,126.9575495,33.51334112,8
마포역 5호선,10,10,126.9458626,37.53955403,20
마포전골목,10,10,126.9536735,37.54463629,20
마포진짜원조최대포 본점,3,3,126.9519706,37.5445374,6
마포집,4,5,127.1263365,37.5360436,9
마피아피자&펍,2,3,126.9078196,37.51744061,5
마할로,3,4,126.9919669,37.53483862,7
마호가니 광화문 케이스퀘어시티점,4,4,126.980078,37.56857238,8
마호가니 스타필드고양점,5,5,126.8955938,37.64730139,10
마호가니 타임스퀘어점,10,10,126.9033407,37.51707482,20
만고쿠 안산중앙점,4,4,126.8361119,37.31793341,8
만나서방가워 본점,4,4,126.7715899,37.6574346,8
만다린,5,5,127.1034628,37.24306764,10
만돈만리,4,5,127.2289454,37.53633247,9
만동제과,13,14,126.9272689,37.5615329,27
만두집,5,5,126.7735053,35.30218656,10
만두집 미사점,4,4,127.2164011,37.54923679,8
만랩커피 경기광주쌍령점,5,5,127.2681124,37.40494434,10
만랩커피 부천역곡점,5,5,126.8122051,37.48627398,10
만리성,8,9,127.5072162,37.29046967,17
만리장성,4,3,127.0173536,37.27949026,7
만리진 청담지점,5,5,127.0389612,37.52528545,10
만리향샤브샤브 사우점,3,3,126.7146852,37.62083263,6
만복국수집 강남터미널점,3,3,127.0069827,37.50600298,6
만복식당,5,5,128.3347169,36.12955391,10
만석공원,18,18,127.0014437,37.30045508,36
만석공원 만석거,4,4,127.0009565,37.29991807,8
만석꾼,3,3,126.9732428,37.57657007,6
만석돼지,5,4,126.9412833,37.37057589,9
만석장 롯데몰 김포공항점,5,5,126.8027176,37.56355647,10
만세해장국밥 평택본점,4,4,127.1092941,37.01139381,8
만수천공원,4,4,126.9078302,37.47386974,8
만안교,3,3,126.9118453,37.41447434,6
만원수산,1,2,126.9090012,37.51871644,3
만의골느티나무집,4,4,126.771741,37.45953577,8
만족오향족발 시청본점,13,14,126.9760138,37.56325755,27
만토바모텔,3,2,126.9214554,37.61800337,5
만포면옥 본점,4,4,126.9550848,37.67423513,8
만학,3,4,127.0433584,37.54663042,7
만해기념관,2,3,127.1808524,37.47731726,5
만해한용운심우장,3,3,126.9916707,37.59364843,6
말똥도넛 파주점,25,26,126.7045257,37.73036183,51
말자동차,3,3,127.1010802,37.50387321,6
맑은빛성모안과의원,3,3,126.9106874,37.55601463,6
맘모스회센타 2호,4,4,126.6042805,37.45485533,8
맘스키친,2,3,126.9644728,37.5929442,5
맘스터치 강남역점,5,5,127.0268707,37.50163206,10
맘스터치 모란역점,3,3,127.1295643,37.4317898,6
맘스터치 성수역점,5,5,127.0571888,37.5437107,10
맘스터치 세종반곡점,3,3,127.3106846,36.49725182,6
맘스터치 용인둔전점,3,3,127.2165621,37.2691964,6
맘스터치 용인민속촌점,3,3,127.1146758,37.25572239,6
맘스터치 청평점,5,5,127.4227153,37.73781892,10
맘스터치 춘천메가박스점,3,3,127.7201908,37.86654939,6
맛고을 장단콩두부마을,4,4,126.6888505,37.7878561,8
맛드림김밥랜드 영등점,4,4,126.9716184,35.95630962,8
맛에반할소 본점,5,5,126.9734008,37.24571748,10
맛을담은 강된장,5,5,126.5281752,33.5163432,10
맛있게,5,5,126.7501836,37.66988868,10
맛있는김치찜&순두부 종로본점,5,5,126.984893,37.56965069,10
맛있는발효밥상 궁뜰,4,4,127.3356632,37.33981902,8
맛있는순두부&김치찜 신촌점,4,5,126.9386396,37.55830658,9
맛짱분식,5,5,127.1243456,37.38608488,10
맛찬들왕소금구이 일산라페스타점,4,5,126.7663067,37.66388878,9
맛찬들왕소금구이 종로점,5,5,126.9854432,37.56911737,10
망리단길,9,8,126.9059145,37.55365752,17
망우삼림,5,5,126.9899533,37.56604184,10
망우역 경춘선,3,3,127.0917387,37.60001731,6
망원동티라미수 샤로수길점,5,5,126.9541845,37.4788884,10
망원시장,57,60,126.8883944,37.27224535,117
망원역 6호선,13,13,126.9100943,37.55608266,26
망원정 터,5,5,126.904516,37.54984337,10
망원한강공원,28,28,126.9000276,37.55172455,56
망원한강공원 2주차장,5,5,126.8965043,37.55447316,10
망향비빔국수 궁평본점,19,19,127.1093003,38.02387784,38
망향비빔국수 민락점,1,1,127.1047478,37.7452011,2
망향비빔국수 평내호평점,3,3,127.2470931,37.65393988,6
망향비빔국수 포천직영점,13,13,127.1596762,37.84618396,26
망향휴게소 부산방향,16,16,127.1809288,36.8555526,32
매니베리머치,5,5,126.9582551,37.47788799,10
매덕스피자,3,3,126.9935374,37.53334305,6
매드포갈릭 광화문D타워점,4,4,126.9787451,37.57081473,8
매드포갈릭 롯데시네마월드타워점,3,3,127.104175,37.51401764,6
매드포갈릭 분당서현점,9,9,127.1228476,37.38427359,18
매드포갈릭 수원인계점,1,3,127.0328915,37.26337815,4
매드포갈릭 일산웨스턴돔점,4,3,126.7730684,37.65495885,7
매머드익스프레스 내수동점,3,3,126.9724427,37.57263073,6
매머드익스프레스 동탄호수공원점,5,5,127.1051536,37.16689583,10
매머드익스프레스 시청점,5,5,126.9765635,37.5645596,10
매머드익스프레스 양재역점,5,5,126.4105917,33.24843658,10
매머드익스프레스 포레나광교점,5,5,127.0580981,37.28418701,10
매바위횟집,3,4,126.6185384,37.16185661,7
매봉,7,9,127.0285067,37.42092797,16
매봉골,4,4,127.3526944,37.63375049,8
매봉산,4,4,126.8924015,37.57281557,8
매산시장,5,5,127.0036393,37.26714902,10
매송휴게소 목포방향,3,3,126.8887169,37.2651217,6
매일더맥주 명동점,2,4,126.9839229,37.56458516,6
매트그린,5,5,127.0128443,37.28572603,10
매향1교,5,5,127.0177902,37.28529109,10
매향교,15,16,127.0182134,37.28187428,31
매향오토캠핑장,5,5,126.5287906,33.51265509,10
매화쌈밥 고양점,5,5,126.8635189,37.62661087,10
맥도날드,5,5,129.2882037,35.8436069,10
맥도날드 가산디지털점,5,5,126.8835692,37.48140239,10
맥도날드 강남2호점,10,11,127.0287333,37.49864659,21
맥도날드 고양삼송DT점,10,10,126.8957178,37.64536258,20
맥도날드 고척DT점,3,3,126.8635591,37.49720086,6
맥도날드 과천이마트점,5,5,126.9915582,37.4262742,10
맥도날드 김포장기DT점,9,8,126.6706776,37.64633293,17
맥도날드 노량진점,3,3,126.9435581,37.5135185,6
맥도날드 대전터미널점,5,5,127.4370306,36.34990882,10
맥도날드 대학로점,5,5,127.0021013,37.58286562,10
맥도날드 동인천점,4,3,126.6304538,37.47462166,7
맥도날드 마리오아울렛점,2,2,126.8873716,37.47826246,4
맥도날드 문학DT점,3,4,126.6889073,37.43820544,7
맥도날드 방배점,5,5,126.9971508,37.4816183,10
맥도날드 부산초량DT점,3,3,129.0412625,35.11722507,6
맥도날드 상계DT점,3,3,127.0561948,37.67246798,6
맥도날드 서울교대점,5,5,127.0161366,37.49413223,10
맥도날드 서울시청점,3,3,126.9793676,37.56683694,6
맥도날드 서울역점,9,9,126.9706069,37.55468605,18
맥도날드 서초뱅뱅점,5,5,127.0308513,37.4900982,10
맥도날드 수원화성DT점,5,5,127.0279575,37.28564954,10
맥도날드 신내점,5,5,127.0950389,37.6065649,10
맥도날드 신월남부DT점,5,5,126.8387144,37.51972889,10
맥도날드 신천점,5,5,127.0828395,37.51142342,10
맥도날드 신흥DT점,9,9,126.6344648,37.45699603,18
맥도날드 여의도점,3,3,126.9251096,37.5250591,6
맥도날드 연희DT점,5,5,126.6763564,37.54130425,10
맥도날드 오산DT점,3,3,127.0738607,37.13993726,6
맥도날드 의정부녹양DT점,3,3,127.0386374,37.75661153,6
맥도날드 의정부역점,2,2,127.0485083,37.7399688,4
맥도날드 인천구산DT점,3,3,126.7517851,37.48405702,6
맥도날드 정발산점,5,5,126.7703579,37.65929633,10
맥도날드 종로3점,5,5,126.9904643,37.57056488,10
맥도날드 평택GS,3,3,127.142457,36.99602224,6
맥도날드 합정메세나폴리스점,8,8,126.9134731,37.55071884,16
맥심플랜트,7,7,127.0009968,37.53698957,14
맷차 명동본점,4,4,126.9847333,37.56464293,8
맹꽁이전기차매표소,5,5,126.8923874,37.56686178,10
맹방해수욕장,2,2,129.2323351,37.390182,4
머노까머나 대학로점,10,10,126.9988407,37.5825629,20
머니호텔,4,4,127.1109689,37.51586571,8
머더파커 건대2호점,5,5,127.0678415,37.5413967,10
머른커피앤바,3,4,127.2766695,38.1061866,7
머리미인,5,5,127.1067766,37.61953811,10
머스트스테이호텔 명동점,5,6,126.9776976,37.55688603,11
머큐어 앰배서더 서울 홍대,15,15,126.9224652,37.55518683,30
먹거리집,5,5,127.0300541,37.58592249,10
먹고보자무한리필양꼬치 병점직영점,5,5,127.039287,37.2134114,10
먹보한우,5,5,126.8391415,37.38697071,10
먹빵,4,4,127.0351055,37.26317569,8
먹쇠연탄구이,5,5,127.2289946,37.93392968,10
먹어봐뒷고기 경안점,4,4,127.257311,37.41442902,8
먹어야산다,1,1,127.1841443,37.47720406,2
먹을터,3,3,127.0157998,37.2797698,6
먼치스앤구디스,17,19,127.0533185,37.54312687,36
멀리가는향기펜션,5,5,127.453994,37.81626242,10
멍때림,5,5,126.4103246,37.6070779,10
멍슈슈,3,3,127.234857,37.54095199,6
멍우리협곡캠핑장,5,5,127.2335573,38.09154307,10
메가 엠지씨커피 고덕그라시움점,5,5,127.1647194,37.55806977,10
메가MGC커피 가평점,5,5,127.5140205,37.82961197,10
메가MGC커피 강서등촌점,3,3,126.8659593,37.55192595,6
메가MGC커피 경복궁역점,3,1,126.9720562,37.57714643,4
메가MGC커피 군포송정지구점,4,4,126.9242373,37.31663145,8
메가MGC커피 남양주2청사점,4,4,127.1686088,37.60958573,8
메가MGC커피 돈암한신점,5,5,127.0113595,37.59456358,10
메가MGC커피 뚝섬역점,4,4,127.0487136,37.54739599,8
메가MGC커피 문래에이스하이테크점,5,5,126.899659,37.51438136,10
메가MGC커피 미사역점,5,5,127.1918359,37.56308702,10
메가MGC커피 부천여월점,5,5,126.7958822,37.5199978,10
메가MGC커피 불광시장점,3,3,126.9271096,37.60879889,6
메가MGC커피 상봉역점,3,3,127.0863306,37.59638319,6
메가MGC커피 서울숲역점,3,3,127.0449468,37.54599553,6
메가MGC커피 송도점,4,4,126.6511837,37.39456311,8
메가MGC커피 송도파크자이점,4,3,126.6570925,37.41235114,7
메가MGC커피 신림역점,4,4,126.9295386,37.48289478,8
메가MGC커피 신상도점,5,5,126.9436203,37.49853752,10
메가MGC커피 신포점,4,4,126.6261217,37.47190502,8
메가MGC커피 안산중앙역점,5,5,126.8386943,37.31367147,10
메가MGC커피 월미도점,4,4,126.5979852,37.47555631,8
메가MGC커피 위례와이즈더샵점,5,5,126.6857899,37.79211852,10
메가MGC커피 이천터미널점,4,4,127.4464911,37.27775748,8
메가MGC커피 인천차이나타운점,5,5,126.6192998,37.47692886,10
메가MGC커피 인하대점,3,4,126.6570807,37.45161092,7
메가MGC커피 청구역점,3,3,127.0127245,37.55798036,6
메가MGC커피 화성남양점,4,4,126.8185224,37.20952333,8
메가박스 광명AK플라자,5,5,126.8827736,37.41887218,10
메가박스 동대문,8,8,127.0075939,37.56677003,16
메가박스 동탄,5,5,127.0728265,37.20454271,10
메가박스 마곡,3,3,126.8352383,37.55931399,6
메가박스 성수,10,10,127.0448991,37.54188699,20
메가박스 송도,5,5,126.6624149,37.37914503,10
메가박스 의정부민락,5,5,127.0959404,37.74569512,10
메가박스 이수,5,5,126.9816493,37.48457222,10
메가박스 코엑스 더 부티크 스위트,5,5,127.0587905,37.5124447,10
메가박스 킨텍스,5,5,126.7517361,37.66794585,10
메가박스 하남스타필드,7,8,127.2250624,37.54464623,15
메가커피 송도SK뷰점,4,4,126.6273431,37.41165563,8
메가커피 좌동재래시장점,5,4,129.1750422,35.17405375,9
메나미죠죠,13,13,126.890145,37.50676932,26
메도빅,2,2,127.0057477,37.56476091,4
메디팜호정약국,4,4,127.0493203,37.54423413,8
메르오르카페 본점,13,13,127.039575,37.13496899,26
메리네 정원,4,3,126.9260967,37.48317018,7
메리어트 이그제큐티브아파트먼트 서울,15,15,126.9185591,37.5213075,30
메리어트 이그제큐티브아파트먼트 서울 산책로,2,2,126.9185591,37.5213075,4
"메리어트 이그제큐티브아파트먼트 서울, 수영장",5,5,126.9185591,37.5213075,10
메모리 칵테일 엘피 바,4,4,126.9612202,37.39315025,8
메모리아마넷,5,5,127.0149515,37.27771014,10
메밀꽃바다,5,5,127.1599679,37.05045928,10
메밀로43,5,5,127.2436032,37.46078818,10
메밀마당 충주중앙탑본점,4,3,127.8643011,37.01756165,7
메밀이랑면이랑,4,4,126.8352468,37.54926969,8
메밀집,4,4,127.108635,37.51011588,8
메밀촌 두부마을,2,3,127.5915891,37.53692502,5
메밀향그집,4,4,127.0006702,37.58236829,8
메세나폴리스몰,4,4,126.9139151,37.55116966,8
메세나폴리스몰 주차장,3,3,126.9138208,37.55151918,6
메시,5,5,127.049369,37.54599016,10
메이드바이,3,4,126.9263991,37.55982768,7
메이드인시카고피자,5,5,126.4813281,33.47937258,10
메이커스X이쁘다,5,5,126.9895404,37.57235958,10
메이플베이,4,4,127.5183155,37.79746982,8
메이필드호텔 낙원,4,4,126.8184095,37.54774754,8
메이필드호텔 벨타워가든,8,8,126.8191351,37.54716481,16
메이필드호텔 벨타워가든 및 자연 경관,4,5,126.8187885,37.5475247,9
메이필드호텔 서울,22,22,126.8190967,37.54713772,44
메이필드호텔 캐슬테라스,3,3,126.8191463,37.54720266,6
메이필드호텔 피트니스클럽,3,3,126.8173039,37.54729714,6
메인22,4,4,127.3803077,37.68122035,8
메인스트리트 세곡점,3,4,127.1070238,37.45978434,7
메종 키티버니포니 서울,3,3,126.9104739,37.55096167,6
메종 파이프그라운드,11,11,127.044244,37.5439325,22
메종드멜라,5,5,127.0915458,37.00227006,10
메종드본,5,5,126.795033,37.73235497,10
메종드씨엘,5,4,127.379583,37.59007591,9
메주꽃,1,1,126.6906386,37.81316328,2
메트로타워오피스텔,3,3,127.0470098,37.7341875,6
메트로폴리탄수영장,3,3,127.060809,37.50919151,6
멕시칸라이브그릴 일산대화점,4,4,126.747664,37.67687761,8
멕시칼리,2,2,127.0883897,37.55272488,4
멘부쿠제면소,3,4,126.9734846,37.40835297,7
멘야산다이메 대학로점,7,8,126.9997056,37.58180968,15
멘야하나비 신사점,3,3,127.017596,37.5162481,6
멘지,2,2,126.9104126,37.55493683,4
멘텐,8,9,126.9886024,37.56199624,17
멜로워 성수플래그쉽,11,11,127.0532275,37.54251423,22
멜멜,5,5,126.492769,33.50707896,10
멜팅샵 치즈룸,5,5,126.9789725,37.5710211,10
면담,5,5,128.5946224,35.86973304,10
면사무소앞안흥찐빵,4,4,128.1566048,37.41216865,8
면포도궁,6,7,127.185199,37.47807098,13
면포도궁 팔당본점,4,4,127.2546342,37.54047672,8
명가,3,3,126.985031,37.3434082,6
명가민규태해물칼국수,3,4,126.5408019,37.64106335,7
명가설렁탕,2,2,126.7344301,37.40141448,4
명가원설농탕,3,3,127.02779,37.25946894,6
명가통닭 올림픽공원점,4,4,127.1313336,37.51571238,8
명동거리,131,128,126.9796803,37.54254225,259
명동교자 본점,85,89,126.9856143,37.56255453,174
명동교자 분점,8,8,126.9851365,37.56345547,16
명동난타극장,10,10,126.9837511,37.5634679,20
명동닭한마리 시조점,5,5,127.0061216,37.57036328,10
명동돈가스,8,8,126.9835687,37.56402109,16
명동멀린호텔,8,8,126.9990617,37.56260406,16
명동순대국,3,3,126.9838456,37.56588259,6
명동신세계떡볶이 홍대직영점,4,4,126.9234829,37.55383509,8
명동역 4호선,18,16,126.9864024,37.56096527,34
명동역지하쇼핑센터,4,4,126.9850057,37.56103177,8
명동참치,2,2,126.9803283,37.47743601,4
명동충무김밥,4,4,126.9851954,37.56313112,8
명동칼국수,6,6,126.983783,37.57284906,12
명동칼국수 사당점,3,4,126.9829423,37.47694267,7
명동칼국수마두점,5,5,129.068204,35.15575433,10
명동칼국수샤브샤브 일원점,3,3,127.0802255,37.49129585,6
명동칼국수샤브샤브 잠실점,5,5,127.1030018,37.51628739,10
명동할머니국수 시청점,3,3,126.9764525,37.56479294,6
명동할머니국수 청계광장점,3,4,126.9791405,37.56948944,7
명동함흥면옥 본점,3,3,126.985689,37.56276898,6
명랑핫도그 남양주도농점,4,4,127.1565052,37.60955374,8
명륜당,9,9,126.9958109,37.58619203,18
명륜진사갈비 구리갈매점,3,3,127.1170022,37.63297203,6
명륜진사갈비 남양주청학점,3,4,127.1189831,37.70715581,7
명륜진사갈비 인천학익점,4,4,126.6655587,37.44256745,8
명륜진사갈비 종로관철점,4,4,126.9867608,37.56901841,8
명물숯불닭갈비 양수점,1,1,127.3231651,37.54421037,2
명선다원,3,3,127.3504915,37.5957448,6
명성닭공판장,5,5,127.7256736,37.8589578,10
명성돼지갈비,5,6,127.5663742,36.22031325,11
명성산,4,4,127.3510448,38.09633198,8
명성산억새밭,5,5,127.3567,38.10303934,10
명성황후생가,19,19,127.6556646,37.26087232,38
명신반점,4,4,127.0697465,38.0241458,8
명신식당,5,5,127.2760268,37.00382983,10
명일역 5호선,10,10,127.1440437,37.5513979,20
명작호텔,5,5,127.0074467,37.2691834,10
명장시대 백운호수점,3,3,127.0016935,37.37580468,6
명지계곡,12,12,127.4862354,37.93594351,24
명지대학교 인문캠퍼스,13,12,126.9228242,37.58023474,25
명지반점,5,5,127.5187648,37.90120607,10
명지산카라반글램핑,9,9,127.4475885,37.98144332,18
명지쉼터가든 가평본점,4,4,127.529731,37.87659408,8
명지원,5,5,127.3310724,37.97198002,10
명진일식,5,5,126.6236588,37.47159086,10
명품구제창고형매장,4,4,126.7899599,37.1928923,8
명필름아트센터,4,5,126.6932256,37.72358922,9
명학역 1호선,3,3,126.9355928,37.38446042,6
모나미스토어 성수점,10,12,127.0554468,37.54444134,22
모나미카레,8,8,127.0120303,37.28667581,16
모나캠핑파크 가평점,5,5,127.3585766,37.77476552,10
모나코펜션,5,5,127.3641423,37.75054863,10
모네하우스펜션,10,10,127.3971159,37.76658377,20
모녀김밥 본점,5,5,127.0011229,37.57028415,10
모노맨션 송리단길점,9,10,127.1091575,37.5101208,19
모다아울렛 구리남양주점,6,7,127.1159288,37.63333618,13
모다아울렛 인천점,4,4,126.6477075,37.51004233,8
모던하우스 용산아이파크점,5,5,126.9645305,37.52886533,10
모도리감자탕뼈찜 삼산직영점,5,5,126.7426062,37.52168491,10
모두의 송어,9,9,127.5144974,37.819922,18
모두카페 고잔점,4,4,126.8321736,37.3203787,8
모드니,5,5,126.7667726,37.6410228,10
모란민속장,8,7,127.127236,37.42867121,15
모란소머리국밥,2,2,127.1280641,37.43190316,4
모란역 수인분당선,5,5,127.1291321,37.43205697,10
모란종합시장,2,2,127.1274925,37.43063515,4
모래내시장,4,3,126.7212077,37.45361404,7
모로미 종각역점,3,4,126.9823117,37.57182894,7
모로코코카페,5,5,126.9873315,37.54146597,10
모리셔스브라운 대학로마로니에공원점,5,5,127.0024001,37.58118797,10
모리스가든,3,3,126.9647147,37.69457168,6
모리아셀프주유소,3,3,127.2281859,37.77361618,6
모리츠플라츠,5,5,126.9313711,37.55605369,10
모모분식,5,5,126.6567402,37.53198301,10
모모야 동대문DDP점,3,3,127.0098023,37.56688159,6
모바면가,3,3,127.1138285,36.98996903,6
모비딕수상레저,5,5,127.5348587,37.77389182,10
모센즈스위트,10,13,126.920762,37.54980674,23
모스버거 명동중앙점,5,5,126.9841083,37.56538527,10
모스버거 센트럴시티점,5,5,127.0042117,37.5048282,10
모아아파트,3,3,126.7312545,37.36207951,6
모어그린,4,4,126.9514676,37.73521888,8
모옌 부천점,4,4,126.7816865,37.48632172,8
모이커피클래식 수원,3,3,127.0333123,37.2869853,6
모인,5,5,127.0166563,37.28270077,10
모임 왕십리점,2,3,127.0404326,37.56015003,5
모짜르트캠핑장,15,15,127.5875897,37.58754157,30
모찌의하루,3,3,129.2090462,35.83640122,6
모카,5,5,126.9690376,37.57836382,10
모카가든,5,5,127.1524168,37.61628587,10
모쿠슈라,4,5,126.6982942,37.78826987,9
모터크루,5,5,127.1782192,37.20121248,10
모텔대경,6,6,127.0063794,37.56707283,12
모텔시네마,4,4,126.9892052,37.57319207,8
모텔요기,2,2,126.6732652,37.5085967,4
모토쿠라시,4,4,127.1066349,37.50828506,8
모퉁이네,5,5,126.9269103,37.52078948,10
모트커피,5,5,126.724182,37.49433214,10
모티프원,5,5,126.6981249,37.7863558,10
모힝 낙성대점,5,5,126.9589607,37.47766479,10
목구멍 안양점,4,4,126.9172373,37.40076831,8
목구멍 파주점,10,9,126.7601268,37.71127128,19
목금,4,4,127.048448,37.54266405,8
목동막국수,5,5,127.550476,37.88690653,10
목동종합운동장 목동아이스링크,3,3,126.8792613,37.53073348,6
목란,9,9,126.9304769,37.5683824,18
목멱산방,3,3,126.9868986,37.55811637,6
목멱산호랭이,4,5,126.9853011,37.55535553,9
목시서울인사동,21,21,126.9893491,37.57235686,42
목원의서촌가락,5,5,126.9691977,37.57987753,10
목장카페은아,4,4,127.6203612,37.21254308,8
목포역,10,10,126.3866484,34.79117899,20
목포종합버스터미널,8,8,126.4178119,34.81274021,16
목향원,9,10,127.1017267,37.68322807,19
목화씨라운지,4,4,126.9221042,37.56498042,8
몬드리안 서울 이태원,25,25,126.993108,37.52856412,50
몬스터리움,6,8,126.6840235,35.52454896,14
몬즈,5,5,126.682197,37.32329664,10
몬탁,4,4,126.996955,37.4883227,8
몬터레이17호텔,3,5,127.1243538,37.25616404,8
몰또 이탈리안 에스프레소바 앤 테라스,31,35,126.9861799,37.56423947,66
몰링부스,3,3,127.0406034,37.54745762,6
몰토베네,5,5,126.9166649,37.54621614,10
못골종합시장,2,3,127.0212674,37.27546918,5
못된고양이 수원역로데오점,5,5,127.0018805,37.26756715,10
몽뜨화덕피자,5,5,127.2095206,37.5540461,10
몽마르뜨공원,10,10,127.0038584,37.49537126,20
몽상클레르 반얀트리점,4,2,127.0011271,37.55073612,6
몽실식당,5,5,127.4929737,37.49029096,10
몽쥬이에,15,15,127.2258035,37.45524447,30
몽촌토성나들길,4,5,127.1234886,37.51878335,9
몽크스부처,5,5,126.9992306,37.53545517,10
몽키가든,5,5,127.3768493,37.59693938,10
몽호텔,2,2,126.9884814,37.56887083,4
묘문사,3,3,127.1231018,37.66316587,6
묘오또,4,4,126.9930572,37.49033088,8
묘향손만두,4,4,127.1148162,37.56399524,8
무게로옷집,3,3,127.1106557,37.32170742,6
무계원,3,3,126.9633728,37.59190953,6
무고레,5,5,126.7703738,37.70784637,10
무공돈까스 수원역점,5,5,127.0015705,37.26744641,10
무교동유정낙지 본점,5,5,126.9760441,37.56762919,10
무궁화공원묘원 가람추모관,5,3,127.3915234,37.61615466,8
무궁화동산,3,3,126.9724068,37.58422111,6
무너,5,5,126.7837377,33.34676713,10
무너진만리장성,5,5,127.1384067,37.59961862,10
무니 압구정본점,10,10,127.03972,37.52679708,20
무랑가배,5,5,126.8417202,37.38179421,10
무릉,5,5,127.0815949,37.51002142,10
무명사진관,5,5,127.0157247,37.28696371,10
무명칼국수,2,3,127.0639093,37.61672919,5
무모한초밥 송산그린시티점,5,5,126.8180918,37.28370018,10
무무대전망대,3,3,126.9636734,37.58387637,6
무봉리순대국 본점,4,4,126.1974067,33.36329533,8
무봉리토종순대국 파주운정점,2,3,126.7364421,37.72863827,5
무사스시&참치,5,5,126.9176802,37.61072081,10
무쇠집,4,4,127.0913553,37.53463777,8
무신사 스탠다드 강남,17,18,127.0249337,37.5025443,35
무신사스탠다드 홍대,33,33,126.9223949,37.55534536,66
무신사테라스,15,15,126.9264984,37.55774463,30
무쏘 경기용인동백점,3,3,127.1530747,37.26951176,6
무아레478,5,5,127.3848044,37.66665683,10
무월식탁 파르나스점,4,4,127.061093,37.50933102,8
무이면가,5,5,126.7526912,37.67249599,10
무인다이안호텔,3,3,126.9677241,37.75970736,6
무인양품 강남점,5,5,127.0262096,37.49980136,10
무인양품 롯데마트서울역점,5,5,126.970457,37.55590776,10
무인양품 판교점,5,5,127.112105,37.39425678,10
무인텔투미,3,3,127.0259166,37.25992709,6
무적의돈까스 역삼점,3,3,127.0325678,37.50567434,6
무즐라,5,5,126.6869351,37.78010998,10
무지개맥주,2,3,126.9286559,37.4837502,5
무지개서는마을,8,8,127.494232,37.90956961,16
무지닭갈비,1,2,127.4620184,37.78903326,3
무한상상시민정원,2,2,127.0473926,37.73749699,4
무호정,4,4,126.974816,37.87915619,8
묵리459,4,4,127.2388808,37.16809114,8
묵전 서종점,5,5,127.3807672,37.6464529,10
문가네보리밥정식,8,8,127.1262982,37.96201376,16
문강 유황온천원탕사우나,3,3,127.9539211,36.88546884,6
문경새재도립공원,9,9,128.0766857,36.76190759,18
문경오미자테마공원,5,5,128.0825213,36.74324565,10
문경오픈세트장,5,5,127.7411828,34.73903428,10
문경휴게소 양평방향,24,23,128.152534,36.62064342,47
문경휴게소 창원방향,11,11,128.1498204,36.62068045,22
문교오리랜드,4,4,127.3920156,37.76532508,8
문라이트호텔,3,4,126.7207402,37.49179764,7
문래근린공원,9,9,126.8939435,37.5167424,18
문래동냉삼 인덕원점,3,3,126.9760004,37.40002897,6
문래동창작촌,17,17,126.8976797,37.51426253,34
문래방구,9,9,126.898065,37.51371415,18
문리버,9,9,127.43044,37.50381699,18
문막휴게소 서창방향,3,3,127.8172731,37.29781707,6
문막휴게소주유소 인천방향,3,4,127.817354,37.29705335,7
문산역 경의중앙선,13,13,126.7873954,37.8546269,26
문산자유시장,7,5,126.7846285,37.85737157,12
문원어린이공원,2,2,127.008744,37.42197092,4
문전성시,5,5,126.9002219,37.48317279,10
문정동로데오거리,2,2,127.1233641,37.48987564,4
문지리535,22,21,126.7579951,36.95174553,43
문지리535 주차장,5,5,126.7179844,37.83005093,10
문파스타 엔터식스안양역점,5,5,126.9225894,37.4020613,10
문학경기장역 인천1호선,10,10,126.6984494,37.43465134,20
문학소매점,3,3,126.6208094,37.4735135,6
문호리리버마켓,3,3,127.3553311,37.62477808,6
문호리팥죽 본점,5,5,127.3502438,37.59556173,10
문호종묘,3,3,127.3524489,37.60357755,6
문화공원,4,4,126.7652531,37.67599223,8
문화비축기지,5,5,126.8942367,37.57107561,10
문화식당,9,9,127.0260089,37.56753353,18
문화실험공간 호수,2,5,127.1011103,37.51027303,7
문화역서울284,48,53,126.9715888,37.55588281,101
문화재청 조선왕릉서부지구관리소 김포장릉,4,4,126.7156041,37.61274039,8
물결 한강,5,5,126.8858456,37.56056308,10
물고기자리 안성점,4,4,127.3323512,37.00924332,8
물고기초밥,5,5,126.9172207,37.54915559,10
물금역,15,15,128.9853192,35.30715678,30
물꼬방,5,5,127.159454,37.7957127,10
물꽁오리,4,5,126.7277704,37.53750923,9
물레,10,10,126.6798831,37.17433035,20
물레방아,8,9,126.6732282,37.16493043,17
물안개공원,2,2,127.4779415,37.49914378,4
물왕 버섯농원샤브샤브,1,2,126.82946,37.38287371,3
물왕호수,27,29,126.8333312,37.38263776,56
물의정원,81,85,127.3149941,37.55685359,166
물의정원 자전거,5,5,127.3110599,37.55352313,10
물향기수목원,38,40,127.0595311,37.1663085,78
뮌스터담,9,9,126.784127,37.72677472,18
뮤고양이카페,2,4,127.2571058,37.40989735,6
뮤니버스,3,3,127.0119082,37.28468633,6
뮤니버스 2호점,2,4,127.0128218,37.2861333,6
뮤즈모텔,5,5,127.0847598,37.53723397,10
뮤지엄209,4,4,127.1063691,37.51387152,8
뮤지엄산,10,10,127.8237131,37.41535334,20
뮤직컴플렉스서울,20,20,126.983554,37.57446723,40
므엘르,5,5,126.6795601,37.64024063,10
미가 본점,4,4,127.1219709,37.38672889,8
미가라멘 배곧점,2,3,126.7273396,37.36837051,5
미가순대국,4,4,127.1374525,37.20471332,8
미가촌감자탕 숭의점,4,4,126.6438452,37.46188291,8
미광,4,5,126.6206447,37.48015788,9
미국군참전비,3,3,126.7410999,37.88927832,6
미국식 신당점,3,3,127.0138133,37.5644512,6
미남당&배배꼬,3,4,126.9219173,37.54879929,7
미니스톱 경주천마총점,3,3,129.2154134,35.83457558,6
미니스톱 서래나루점,3,3,126.9931798,37.50980163,6
미니스톱 일산웨스턴점,3,3,126.9474901,33.50993823,6
미니스톱 한강강서1점,4,4,126.8208167,37.5849569,8
미니스톱 한강아라호점,5,5,126.9350732,37.52845277,10
미니스톱 한강양화2점,3,3,126.896247,37.54255272,6
미니에너지 직영주유소,5,5,128.6769045,35.8748257,10
미니타이,4,3,126.7847957,37.67048399,7
미니호텔굿드림,1,2,129.2049785,35.83991795,3
미당등촌샤브샤브,4,4,127.5142615,37.82980282,8
미도인 강남,4,4,127.0271875,37.50210141,8
미도인 성수,2,3,127.0548665,37.54323788,5
미도인 의정부역점,5,5,127.0481678,37.7398428,10
미도인 종로점,5,5,126.9836363,37.57075514,10
미도인 파이낸스여의도점,5,5,126.9241379,37.52388357,10
미도인 홍대,10,10,126.9209727,37.55173321,20
미도커피,4,4,126.9806194,37.55853718,8
미드나잇키친 연남점,3,3,126.9246415,37.56079514,6
미드타운,5,5,127.0224679,37.52007834,10
미라시아,8,9,127.2943544,37.33735568,17
미라클모텔,4,4,127.1056803,38.1849572,8
미락육회막국수,5,5,126.7227987,37.40222393,10
미락회양념집,5,5,126.6057611,37.45357004,10
미란다호텔이천 스파플러스,8,8,127.4517221,37.27609415,16
미래마켓24,3,3,127.072569,37.20152344,6
미래유탑유블레스시티오피스텔,4,4,127.1352417,37.600899,8
미래주유소,5,5,127.0375253,37.29592594,10
미래항공스포츠,5,5,127.4636545,37.55934747,10
미로미로 홍대점,4,4,126.9215453,37.55281479,8
미루꾸커피 밤리단길점,4,4,126.7859493,37.66427203,8
미리내마을  버스정류장,3,3,128.027474,37.668035,6
미리내성지,28,30,127.259162,37.14758825,58
미마지아트센터 풀빛극장,5,5,127.0035095,37.58032839,10
미메시스아트뮤지엄,27,27,126.6889188,37.71679273,54
미메시스아트뮤지엄 카페,5,5,126.6890028,37.71677403,10
미몽펜션,4,4,127.6370685,37.80424103,8
미미고찹쌀꽈배기 미사본점,5,5,127.1896377,37.56393841,10
미미면가 본점,5,6,127.0211036,37.52005336,11
미미옥 신용산점,9,9,126.9629524,37.52628438,18
미미진,5,5,126.6193459,37.47675602,10
미분당 공덕점,5,4,126.9513852,37.54147457,9
미분당 대학로점,4,4,126.9983527,37.58236468,8
미분당 신사점,5,5,127.0200805,37.5178623,10
미분당 중랑점,5,5,127.0941575,37.59827379,10
미분당 홍대점,10,10,126.9303541,37.55441689,20
미쁘동 서울숲,8,8,127.0401203,37.5475605,16
미사강변블루 주차장,3,3,127.186494,37.55462892,6
미사경정공원,32,32,127.2070228,37.55931593,64
미사경정공원 조정카누경기장,5,5,127.2051665,37.56175546,10
미사국수우동집,5,5,127.1920961,37.56260907,10
미사누리공원 1호,4,4,127.1876213,37.5745211,8
미사리경정공원,5,5,127.1260857,35.84332035,10
미사리경정공원 경정장,2,1,127.1995391,37.56770446,3
미사리경정장,3,3,126.1631086,33.29476974,6
미사리밀빛초계국수 강남역점,5,5,127.0310156,37.49365894,10
미사리밀빛초계국수 본점,5,5,127.2109669,37.55325425,10
미사리조정경기장 정문,4,4,127.2039156,37.56040613,8
미사리조정경기장체육여가공원,3,3,127.2051733,37.56173743,6
미사역 5호선,16,16,127.192491,37.56299135,32
미사역효성해링턴타워더퍼스트오피스텔,14,14,127.1904179,37.56673204,28
미사장,7,8,127.2066508,37.56397653,15
미사한강공원 1호,4,4,127.1788416,37.57654755,8
미사한강공원 4호,5,5,127.1888455,37.57966743,10
미사호수공원,47,45,127.1881764,37.56165132,92
미선네 양념식당,1,2,126.3101642,33.46295695,3
미성양꼬치,4,4,127.109736,37.51433876,8
미성옥,5,5,126.9839366,37.56417071,10
미세노센세,5,5,127.3888768,36.34610285,10
미소삼겹살데이,5,5,126.8927126,37.47575631,10
미소야 웅진플레이도시점,4,4,126.7441327,37.4999993,8
미소의집,5,5,126.9877294,37.5021967,10
미술관옆사진관,5,5,126.9795642,37.5723772,10
미스사이공,3,3,126.8847162,33.52652485,6
미스사이공 신도림점,3,5,126.8881447,37.50954344,8
미스진햄버거 송탄본점,4,4,127.0500462,37.08037756,8
미스터브리즈커피 도봉산입구점,4,4,127.0406147,37.68695851,8
미스터빠삭 서울당산점,3,3,126.8983044,37.52898545,6
미스터순두부보쌈 건대스타시티점,5,5,127.0729758,37.53857892,10
미스터스파 교대본점,5,5,127.0129815,37.49287301,10
미스터왕왕,5,5,126.9239915,37.52101469,10
미스터케밥 이태원점,4,4,126.9953567,37.53440271,8
미스터타코야끼,4,4,126.69883,37.59317258,8
미스터힐링 종각역점,5,5,126.9843609,37.56993714,10
미시간닭갈비,1,1,127.4883481,37.67250109,2
미식,5,5,127.0462261,37.93734355,10
미식가양꼬치,3,3,126.8999026,37.48268598,6
미식가의주방,10,10,127.0138121,37.28687384,20
미아논나,4,4,127.0527944,37.5443894,8
미아역 4호선,10,9,127.0260411,37.62665449,19
미앙,2,2,127.0288657,37.52532169,4
미엔아이 송파점,5,5,127.1091292,37.51088308,10
미정국수0410 미사강변점,3,3,127.184615,37.56963885,6
미즈컨테이너 이스트점,5,5,127.0268121,37.50216907,10
미즈컨테이너 타임스퀘어점,5,5,126.9030703,37.51711244,10
미즈호텔,3,3,126.6870578,37.77685244,6
미추홀공원,7,8,126.6499406,37.38212177,15
미친쭈꾸미 건대본점,4,4,127.0700717,37.54258652,8
미카사,8,8,127.0136412,37.28385178,16
미투,15,15,126.597659,37.47482449,30
미트볼라운지,5,5,127.0016202,37.53677423,10
미호박물관,5,5,127.1806376,37.592696,10
믹스트,4,4,126.7748873,37.66731116,8
민들레울,9,9,127.162324,37.78109158,18
민물고기연구소 민물고기생태학습관,4,4,127.6391656,37.51168729,8
민속떡방아간,4,4,126.5545223,33.24721232,8
민속박물관 뮤지엄숍,5,5,126.9790375,37.58167807,10
민속식당 이천쌀밥집,2,2,127.3658912,37.23625831,4
민이네숯불닭갈비막창,3,4,126.7704244,37.75757273,7
민지네,4,4,126.6148384,37.47766043,8
밀곳,6,7,127.9917541,37.76895201,13
밀곳간,5,5,126.9993387,37.59409561,10
밀도 광교앨리웨이점,4,4,127.0606719,37.27488969,8
밀도 성수본점,10,10,127.0448926,37.54624422,20
밀란,4,3,126.9922025,37.56538068,7
밀레니엄호텔,5,5,126.7483438,37.67497349,10
밀레니엄힐튼 서울,30,30,126.9754867,37.55532687,60
밀리오레,9,9,127.0085121,37.56825481,18
밀리오레호텔 명동,35,33,126.9842111,37.56104969,68
밀리토피아호텔,4,4,127.1438828,37.46819759,8
밀본,3,3,126.4558332,37.43728021,6
밀숲 과천점,3,3,126.9983229,37.4495315,6
밀크북,4,3,126.6876501,37.7073828,7
밀플랜비 인하대점,4,4,126.6576514,37.45135308,8
밀피유 명동점,5,5,126.9851184,37.56334194,10
밀화당 강서직영점,3,3,126.8338092,37.55865426,6
밍차이,7,8,126.7498319,37.66829591,15
밑미흠 시간을파는상점,5,5,127.1128895,36.46151684,10
바나나하루키,5,4,126.9246768,37.56169346,9
바나바나 건대본점,4,4,127.0673879,37.54027612,8
바나프레소 AK금정점,5,5,126.9441155,37.37252798,10
바나프레소 강남점,3,3,127.0302563,37.49508813,6
바나프레소 남부터미널점,4,4,127.0168832,37.48529504,8
바나프레소 선릉역사거리점,4,4,127.0482923,37.50465262,8
바나프레소 신촌점,4,4,126.9376737,37.55752942,8
바늘이야기 연희직영점,5,5,126.9290629,37.56743552,10
바다담은해물손칼국수 본점,4,3,126.8493274,37.68251213,7
바다생각,5,5,127.0702949,37.54652015,10
바다수산 본점,3,2,126.9755738,37.39898911,5
바다수퍼 방이본점,3,3,127.1092965,37.51312372,6
바다양푼이동태탕 청량리점,5,5,127.0460638,37.58118801,10
바다와소나무,5,5,128.6081672,38.1368498,10
바다의맛,5,5,126.5271895,37.2443954,10
바다의화원,4,4,127.1245523,37.53537508,8
바다해맞이펜션,6,6,126.5652896,37.20121032,12
바다향기수목원,7,7,126.6465283,37.22502218,14
바당,4,4,127.3599874,37.75273272,8
바라산,4,4,127.0270693,37.36869701,8
바라산 숲길 전망대,3,4,127.0196199,37.3728728,7
바라산자연휴양림 캠핑장,9,9,127.0193147,37.37310185,18
바란다,4,5,126.5203074,33.51553467,9
바람새마을,13,13,126.8471113,36.36017776,26
바람의마을,4,4,126.531042,37.23453535,8
바르다김선생 광화문점,9,9,126.9729223,37.57375529,18
바르미샤브 바르미스시,5,5,126.7855966,37.59925997,10
바르미샤브샤브 현대백화점 디큐브시티점,4,4,126.889598,37.50879787,8
바르바커피 오산점,5,5,127.065894,37.15255679,10
바른갈비탕,4,4,127.2902363,36.47791763,8
바른곱창 역삼점,3,4,127.0317295,37.49194413,7
바른순대국찰솥밥,3,3,127.1511521,37.27158843,6
바른식생활교육체험관,9,8,126.9887734,37.28183551,17
바리스타엘리 후암점,5,5,126.9782326,37.54631472,10
바링고빈스,6,6,126.9889629,37.20760671,12
바모스호텔,5,5,126.9086807,37.51998751,10
바바커피 수원인계점,8,8,127.0337762,37.26278862,16
바바호호텔,5,5,127.1194539,37.70654987,10
바비레드 스타필드고양점,4,4,126.8947784,37.64697721,8
바비레드 하남점,3,4,127.22382,37.54541715,7
바스버거 광화문점,4,4,126.9797046,37.56811281,8
바스버거 여의도점,2,3,126.9272932,37.52488026,5
바앤복히든살롱,5,5,128.1701958,35.58074463,10
바오스앤밥스,5,5,126.7343556,37.38922532,10
바오차이 시흥프리미엄아울렛점,3,3,126.7356731,37.37935578,6
바우다,3,3,126.6506206,37.39763932,6
바운스슈퍼파크 수원영통센터,4,5,127.0619095,37.2451669,9
바운스트램폴린파크 삼성센터,5,4,127.0655497,37.50333244,9
바울아저씨,5,3,126.9806376,37.28615764,8
바위섬조개구이,4,4,126.4096223,37.43826847,8
바위와소나무,4,4,127.1199177,37.66784704,8
바이더레이크,5,5,127.1064397,37.50939347,10
바이러닉 에스프레소 바 여의도점,5,5,126.9185821,37.52518092,10
바이러닉 에스프레소바 합정본점,4,4,126.9185123,37.54775093,8
바이스테이션,15,16,127.5122394,37.81399459,31
바이올린모텔,2,2,126.9518006,37.47977044,4
바이크토탈 팔당점,10,9,127.2451789,37.54586848,19
바이클리,5,5,126.9683249,37.52372709,10
바캉스인미사,5,5,127.2006353,37.55943508,10
바탕골 소극장,7,7,127.0025224,37.58182406,14
바토스 이태원점,6,6,126.9901748,37.53460422,12
바토스 파르나스몰점,2,2,127.0608681,37.50954467,4
바통 밀카페,4,4,126.9626333,37.526487,8
바푸리포 천안아산역 KTX점,2,2,127.1044475,36.79456006,4
박가네빈대떡,18,18,127.0008444,37.57051661,36
박가네빈대떡 2호점,1,3,127.0013448,37.57047516,4
박가부대 춘천강원대점,3,3,127.7448213,37.87323511,6
박공헤어 경리단하우스,1,1,126.989545,37.53930919,2
박군자진주냉면 수원본점,3,3,127.0361828,37.26220584,6
박물관역,5,5,126.5974796,37.47033327,10
박물관은살아있다 인사동점,5,5,126.9872765,37.57179354,10
박물관카페,5,5,126.6909245,37.33554311,10
박민준커피스튜디오,4,4,127.1247832,37.41844187,8
박승광 최강해물손칼국수 본점,5,5,126.6581313,37.64841634,10
박승광해물칼국수 서종직영점,15,15,127.3532369,37.62269048,30
박승남소아청소년과,3,3,127.0339762,37.7577662,6
박지후스시,4,4,126.992231,37.56292546,8
박태준만화회사,3,3,127.0222165,37.51932335,6
박하사탕펜션,3,4,127.5124192,37.80254093,7
반계리은행나무,1,1,127.788431,37.29425009,2
반달커피 동백점,4,3,127.1501704,37.27400987,7
반달커피 초월점,4,4,127.2971631,37.37199848,8
반디앤루니스 미사역점,4,4,127.1924072,37.56344018,8
반미프엉,3,3,126.9224618,37.56498246,6
반스 강남점,4,4,127.0254746,37.50341005,8
반얀트리클럽&스파서울,10,10,127.0011294,37.55072891,20
반월카페,9,8,127.1840021,37.47912343,17
반지그리기,5,5,126.9837712,37.575134,10
반치앙마이,4,3,127.1906741,37.56067333,7
반포 한강공원,5,5,126.9768967,37.57760878,10
반포낭만달빛마켓,5,5,126.9976338,37.51131189,10
반포대교,9,9,126.9965026,37.5145843,18
반포대교 달빛무지개분수,10,10,126.9984074,37.51264539,20
"반포대교, 잠수교, 세빛섬, 반포한강공원",5,5,126.4089331,33.48484028,10
반포한강공원,69,69,126.9946298,37.50970079,138
반포한강공원 달빛광장,38,38,126.9976293,37.51135513,76
반포한강공원 반포2주차장,3,3,126.9960526,37.5101081,6
발루지컴퍼니,4,4,127.1927132,37.59476359,8
발리맥주 본점,5,5,126.7762254,37.49918507,10
발트 본점,5,5,126.9255018,37.56299141,10
발트바우,5,5,126.8737475,37.67383194,10
밝은광장 인증센터,3,5,127.3125483,37.55330657,8
밝은광장바이크카페,3,3,127.3128912,37.55329755,6
밤가시공원,6,6,126.7828028,37.66900183,12
밤골펜션,4,4,127.5672658,37.89604871,8
밤꽃마을뜨란채아파트,3,3,126.9685653,37.30610942,6
밤듸농원,4,4,127.223385,37.61727388,8
밤섬유원지,3,4,127.1630908,37.69602106,7
밤을 걷는 밤 16화(합정동),5,5,126.9178391,37.548592,10
밥상편지,3,3,126.645101,37.38553302,6
밥앤독,5,5,127.3620609,37.75956737,10
밥한끼,3,3,127.0079199,37.53393762,6
밥할머니공원,5,5,126.9000082,37.64746378,10
방아머리해수욕장,58,61,126.5767674,37.28915268,119
방아머리해수욕장 공영주차장,4,4,126.5749054,37.28655825,8
방이옥 본점,8,8,127.1095258,37.51368123,16
방일해장국 설악점,4,4,127.4872445,37.67741415,8
방축천,4,4,127.2575686,36.5130584,8
방탈출 미로,4,4,126.918543,37.61925917,8
방탈출버스티드,3,5,126.7796528,37.4873523,8
방태막국수 본점,3,3,126.9753332,37.71852588,6
방태막국수 아침고요수목원점,4,4,127.3628314,37.76397431,8
방태막국수 풍동점,4,4,126.7881028,37.67418849,8
방학동도깨비시장,3,3,127.0351013,37.66507369,6
방학역 1호선,3,2,127.0443217,37.66743837,5
방화수류정,209,218,127.0180746,37.28750616,427
배곧생명공원,14,14,126.7214806,37.37140953,28
배다리공원,5,5,126.4270716,33.49234914,10
배다리도서관,5,5,127.1193452,37.00226699,10
배다리생태공원,13,13,127.120595,36.99972829,26
배다리성냥마을박물관,4,4,126.6377381,37.47289987,8
배다리역사문화마을,4,3,126.6366631,37.47264789,7
배다리저수지,10,10,127.1184526,37.00047654,20
배론성지,5,5,128.0824727,37.16063522,10
배마루된장찌개,3,3,127.0905525,37.18183747,6
배말공원,3,3,127.1122698,37.6139613,6
배봉산,10,10,127.0639366,37.58108058,20
배부장찌개 광교법조단지점,5,5,127.0695467,37.29215323,10
배부장찌개 송도 랜드마크시티점,4,4,126.6256631,37.41035106,8
배상면주가 포천점,3,3,127.3099043,37.90599551,6
배스킨라빈스 BROWN청담점,4,4,127.0375981,37.52311988,8
배스킨라빈스 가천대역점,4,4,127.1272368,37.44778894,8
배스킨라빈스 강남신논현점,5,5,127.0247582,37.50183975,10
배스킨라빈스 고속터미널경부선점,8,8,127.0055802,37.50507502,16
배스킨라빈스 대학로점,4,3,127.0019768,37.58373869,7
배스킨라빈스 삼청마당점,12,12,126.9822624,37.57901166,24
배스킨라빈스 서울대병원점,2,1,126.9987909,37.57843635,3
배스킨라빈스 세종다정점,5,5,127.2491481,36.49501533,10
배스킨라빈스 송탄신장점,5,5,127.0514501,37.0809978,10
배스킨라빈스 수원남문점,3,4,127.0156548,37.27646931,7
배스킨라빈스 옥수역점,4,4,127.0166154,37.54218628,8
배스킨라빈스 운정해솔가람마을점,4,3,126.7516111,37.73125519,7
배스킨라빈스 인천연수점,4,4,126.6757124,37.41418499,8
배스킨라빈스 인천옥련점,4,2,126.6444188,37.42428728,6
배연정소머리국밥,3,3,127.3389007,37.35033197,6
배오개다리 진출입 계단 14번,5,5,126.9982115,37.56885696,10
배키욘방,3,4,127.1083367,37.51350032,7
배키욘방 익선점,5,5,126.9898289,37.57368497,10
배키욘방 행리단길점,4,4,127.011818,37.28496025,8
백`s비어,3,3,126.9191792,37.61959478,6
백남준아트센터,25,28,127.1103669,37.26922589,53
백년교동짬뽕 본점,4,4,126.8637986,37.60742376,8
백년서점,4,4,127.0154942,37.28504993,8
백년옥 본관,4,4,127.0137754,37.48118324,8
백년짬뽕,4,4,127.1930738,37.27387199,8
백돈,5,5,127.0934303,37.59809507,10
백두대간,5,5,127.1468696,37.42956027,10
백령면옥,5,5,126.6604357,37.46794867,10
백마권역활성화센터,1,1,127.6509482,36.83884173,2
백만불식품,3,3,126.9960768,37.56738919,6
백미당 삼청점,4,4,126.9802425,37.5801538,8
백범광장,20,20,126.9792487,37.55482844,40
백사실계곡,3,4,126.9654386,37.60071824,7
백석역 3호선,16,16,126.7881315,37.64296237,32
백소정 구리점,4,4,127.1407185,37.60114217,8
백소정 부천역점,10,10,126.7817228,37.48551629,20
백소정 시흥은계점,3,3,126.8025387,37.44675813,6
백스트리트피자,5,5,126.9898914,37.5720785,10
백암순대,5,5,127.2154901,37.26807026,10
백암왕순대,4,4,127.1254189,37.50964875,8
백암토종순대,5,5,126.8400955,37.516344,10
백야,5,5,126.7614604,37.71485265,10
백양사휴게소 순천방향,3,3,126.8053673,35.39439399,6
백운가든,3,3,127.5163728,37.49976771,6
백운계곡,10,11,127.4163014,38.06772219,21
백운계곡관광지,5,5,127.4099696,38.07154901,10
백운동,5,5,127.0004065,37.38110092,10
백운메밀,9,9,127.0031277,37.38330839,18
백운산,4,4,127.0181367,37.35225857,8
백운역 1호선,5,5,126.7072944,37.4833425,10
백운주말농장,5,5,127.015567,37.33186051,10
백운호수,36,35,127.0033827,37.3788411,71
백채김치찌개 양재시민의 숲점,3,3,127.0409465,37.46920614,6
백청우칼국수 본점,5,5,127.0267078,37.27237931,10
백청우칼국수 조원점,5,5,127.0127007,37.30368012,10
백학자유로리조트,3,3,126.9488059,38.00822335,6
밸류하이엔드호텔 수원,3,3,127.0346493,37.26146744,6
밸리러브,10,10,127.5500496,37.88017222,20
뱅스시,4,5,127.01369,37.48424128,9
버거더심플,3,2,126.7626368,37.50344012,5
버거리 신촌점,3,3,126.9363328,37.55587988,6
버거보이 성수낙낙점,9,8,127.0658816,37.54639115,17
버거비치,8,8,126.5755847,37.28809244,16
버거스테이지,5,5,127.0113318,37.28372408,10
버거카페아메리카,3,3,127.2013597,37.29369723,6
버거킹 가양역점,5,5,126.8532448,37.56177764,10
버거킹 고양덕양FS점,4,4,126.908045,37.71309397,8
버거킹 고양덕이DT점,3,3,126.7598012,37.69340612,6
버거킹 과천중앙점,5,5,126.5331605,33.50701956,10
버거킹 동두천DT점,3,3,127.0565337,37.88996478,6
버거킹 미사역파라곤스퀘어점,5,5,127.1930294,37.56461406,10
버거킹 반포고속터미널점,4,5,127.0065597,37.50597057,9
버거킹 서울역점,4,5,126.9717341,37.55483769,9
버거킹 성남이마트점,3,3,127.1414012,37.44401562,6
버거킹 수원역사점,3,3,127.0002074,37.26624083,6
버거킹 수원호매실SK점,3,3,126.9618691,37.2667654,6
버거킹 시청역점,4,3,126.9761088,37.56363329,7
버거킹 신길점,4,4,126.9171253,37.51260191,8
버거킹 신논현역점,3,3,127.0250793,37.50487968,6
버거킹 안성공도DT점,4,4,127.1798863,37.00424515,8
버거킹 의정부신세계점,5,5,127.0463554,37.73710819,10
버거킹 정읍중앙점,4,4,126.850378,35.5678054,8
버거킹 제주노형점,5,5,126.4815843,33.4869272,10
버거킹 종로구청점,8,8,126.9805139,37.57251701,16
버거킹 청담점,4,4,127.0397163,37.52422922,8
버섯마루,5,5,126.9120361,37.55247292,10
버즈네스트호스텔,4,4,126.9214743,37.56119042,8
버터 홍대점,5,5,126.9225837,37.55656723,10
버터베이커리,5,5,126.9240221,37.55997033,10
버터부띠끄,5,5,127.0141141,37.28572408,10
버터북 행궁점,20,21,127.0097655,37.28378909,41
버터우드,2,2,127.0272562,37.78664386,4
버터킹빵공장 주차장,13,13,126.6989729,37.72642406,26
버터핑거팬케익스 롯데백화점 잠실점,5,4,127.098589,37.51185462,9
버틀러리 제이엘,19,19,126.9235563,37.55947088,38
벅시분식,5,5,127.1428421,37.59239911,10
번지없는주막,16,17,127.2897966,37.3397123,33
번패티번,5,5,126.9284462,37.52582161,10
벌교추어탕,5,5,127.0546595,37.24622866,10
벌말근린공원,4,4,127.1771,37.56007098,8
벌말주유소,5,5,126.7631842,37.53851178,10
벌이랑꿀이랑,5,5,126.9581489,36.93514177,10
벌툰 구리돌다리점,3,4,127.140171,37.60085,7
벌툰 당산점,5,5,126.9042433,37.53299086,10
벌툰 종각점,5,5,126.9870686,37.56965275,10
범계역 frank burger,5,5,126.9514797,37.3907305,10
범계역광장,12,11,126.951077,37.38965052,23
범륜사,3,3,126.9519031,37.93838068,6
벗고개,5,5,127.7312275,37.50322095,10
벙커컴퍼니 압구정점,10,10,127.0312237,37.52635093,20
벚골펜션,5,5,127.2558467,38.13111149,10
베누스,3,3,126.839626,37.64332471,6
베니키아 월미도 더 블리스호텔,2,2,126.597379,37.47285664,4
베드라핀,3,3,127.0337585,37.50276015,6
베드스테이션 선릉점,10,10,126.9817448,35.47636955,20
베라노펜션,1,1,127.4883434,37.70255744,2
베란다,5,5,126.9705557,37.57542697,10
베러 스퀘어,5,5,126.753593,37.37821324,10
베렌트레프,4,5,127.5696329,37.23789265,9
베로니카화원,3,3,126.9865488,37.56453143,6
베르2모텔,2,4,126.8918107,37.50301006,6
베르트,9,10,126.9774159,37.54864202,19
베리굳베이글,3,3,126.8125622,37.67732746,6
베비아모 에스프레소바,5,5,127.0757421,37.62441663,10
베스트슬립 잠실점,3,4,127.0972598,37.50210685,7
베스트웨스턴 하버파크호텔,31,32,126.6196522,37.4720952,63
베스트웨스턴프리미어 강남호텔,6,8,127.029779,37.50637245,14
베스트트레드빌오피스텔,5,5,127.0887984,37.53852123,10
베어스치어스,3,4,126.6711733,37.64492158,7
베어스타운,9,10,127.2486229,37.79848458,19
베오,5,5,127.0508214,37.73802624,10
베이커리 무이,8,8,126.9668925,37.53961135,16
베이커리 씨어터,7,8,127.3760252,37.67343885,15
베이커리 씨어터 수목원,3,2,127.3760252,37.67343885,5
베이커리시어터 이석영광장점,5,4,127.2066646,37.63282292,9
베이커리카페리코,4,4,126.9427709,37.31444695,8
베이커리카페콤마,4,4,127.4249345,37.50242686,8
베이커리텐,5,5,127.0118664,37.56343599,10
베이크,5,4,126.7840272,37.66931041,9
베이크샵 켜켜이,3,3,126.6507261,37.53336012,6
베즐리 더현대서울점,5,5,126.9284461,37.52585856,10
베트남노상식당,3,4,126.3499421,37.53374439,7
베티버,3,3,127.053191,37.53891925,6
벨라스위트호텔,8,8,127.0336668,37.26263548,16
벨라시타,11,11,126.7914516,37.64205468,22
벨라쿠키 안국,3,3,126.9859285,37.57693806,6
벨라쿠키 연남,4,4,126.9245227,37.56193302,8
벨루스,5,5,127.0020366,37.53749502,10
벨리노에스호텔,5,5,127.1086188,37.29703717,10
벨뷰,5,5,127.0419562,37.52420683,10
벨스타커피,5,5,127.2545207,37.54036704,10
벼락소유원지,5,4,127.193951,37.72421083,9
벽산라이브파크아파트,5,5,127.0113907,37.6208004,10
벽오동,4,5,126.9824345,37.57883149,9
벽초지수목원,63,71,126.8742585,37.80077004,134
벽초지수목원 주차장,3,3,126.873985,37.80134997,6
변강쇠해장국,4,4,127.2800734,37.84634837,8
별난독서캠핑장,4,5,126.8774173,37.88457463,9
별내동 카페거리,9,9,127.1270008,37.65801173,18
별내체육공원 테니스장,5,5,127.1202402,37.6647158,10
별마당도서관,25,26,127.0599755,37.51073536,51
별망성지,1,1,126.7978838,37.29909675,2
별미곱창,3,3,127.1301619,37.43239102,6
별미지교 인천서구점,2,3,126.6614134,37.485267,5
별밤야영장,4,5,127.3742327,37.04844868,9
별별룸카페,3,4,126.7286562,37.37016117,7
별빛마을포토랜드,5,5,126.863449,37.33941988,10
별빛정원 우주,4,5,127.3928263,37.24216754,9
별이 내리는 숲,4,5,127.2080792,38.056848,9
별이네카페,16,16,127.0170193,37.2871942,32
병목안시민공원,9,9,126.9091067,37.38494039,18
병점역 1호선,24,24,127.0332004,37.2067527,48
병천순대국밥,3,3,129.174223,35.17477856,6
병천유황오리,5,5,126.8831667,37.45525467,10
보고리반상,5,5,127.4640581,37.54084133,10
보광사,7,7,126.9585702,37.64004206,14
보광호,5,5,126.496186,37.5983938,10
보나리베카페,13,14,127.1068533,37.64701989,27
보나카바,5,5,127.0647829,37.19600271,10
보납산,5,5,127.5184052,37.83854995,10
보넷길,10,10,126.9100039,37.06261091,20
보노보노플러스 삼성점,4,4,127.058043,37.50694039,8
보누 광명본점,5,5,126.8526844,37.47957311,10
보돌미역 백석직영점,4,4,126.7904521,37.64453782,8
보드레안다미로,2,2,126.9807425,37.58148375,4
보드코리아 강남점,3,4,127.0324887,37.51122815,7
보라매공원,37,36,126.9205176,37.49328308,73
보라보라,4,5,126.9237596,37.56216139,9
보라앤드,3,3,126.9255698,37.56290136,6
보령약국,18,19,127.0003453,37.5711428,37
보릿고개,4,4,127.1809952,37.03172275,8
보물나라캠프,5,5,127.1429311,38.15454653,10
보물섬글램핑,5,5,126.6449034,37.19907442,10
보보스모텔,3,3,126.9106011,37.52214778,6
보스골뱅이치킨,5,5,127.2181826,37.54041725,10
보스코,5,5,126.7949755,37.73264499,10
보승회관 신촌점,3,3,126.9354948,37.55655697,6
보승회관 을지병원사거리점,3,3,127.0289187,37.51890113,6
보신각터,6,6,126.9836456,37.56976765,12
보안1942,3,3,126.9736687,37.57900104,6
보안여관,6,8,126.9736268,37.57910825,14
보야지투자라섬,10,9,127.5279638,37.81622498,19
보얀트,4,4,127.1910064,37.70830808,8
보영만두,4,4,126.9237296,37.31662302,8
보영만두 북문본점,52,53,127.0143933,37.2895012,105
보용만두 북문본점,3,3,127.0145794,37.28963814,6
보정동카페거리,19,20,127.1101005,37.32162865,39
보정역 수인분당선,5,5,127.1083368,37.31277492,10
보코서울강남,19,19,127.0245452,37.51782722,38
보타니카바이선리,5,5,126.492769,33.50707896,10
보타닉파크웨딩,5,5,126.8267363,37.56713327,10
보테가9,5,5,126.6289612,37.40603929,10
보통저수지,7,7,126.9747838,37.19462291,14
복골캠프,5,4,127.3502505,37.97487323,9
복드림한우,5,5,126.6873007,37.78925028,10
복많네해물칼국수,10,10,126.7027665,37.72803201,20
복사꽃피는집 시흥점,5,5,126.7967219,37.39878807,10
복사꽃피는집 청라점,5,5,126.6577891,37.53269604,10
복포천,3,3,127.4092977,37.5157673,6
복합문화공간야시시,5,5,126.9297929,37.55425077,10
복향원판점,3,4,126.9982344,37.56092099,7
복호두 광명점,5,5,126.8821536,37.44687064,10
본가곱돌숯불닭갈비,4,4,127.3621445,37.75971938,8
본가냉면,5,5,126.9714681,37.70588075,10
본가신숙희진골막국수,18,18,127.3784683,37.77203828,36
본가양평해장국,3,3,127.4710679,37.49083895,6
본가청담칼국수,5,5,126.6877531,37.34111665,10
본동신동아아파트,14,12,126.9518131,37.50968748,26
본래순대 용문역점,3,3,127.5938161,37.48272098,6
본만두 아주대점,5,5,127.0406232,37.2766598,10
본수원갈비 본점,9,9,127.0406059,37.27796902,18
본죽 상수역점,4,4,126.9234554,37.54751908,8
본지르르,5,5,127.016689,37.2828161,10
본치과교정과치과의원,5,4,127.031186,37.26107916,9
볼더메이트클라이밍,5,5,127.1179474,37.28055907,10
볼더프렌즈 클라이밍,4,4,126.9221288,37.55438292,8
볼원볼링센터,5,5,127.0474444,37.71375007,10
볼원볼링장,5,5,127.1883059,37.23547364,10
봄날쌈밥,3,3,127.2250345,37.28160682,6
봄날아트홀,17,18,127.0042477,37.5799968,35
봄소와 남양주마석점,3,3,127.2827332,37.65221646,6
봄의정원 성수점,4,4,127.0582475,37.54169645,8
봄키즈가족스파펜션,5,5,127.5196137,37.90097889,10
봇들저류지공원,5,5,127.1115424,37.39941116,10
봇봇봇,2,3,127.0584569,37.54467415,5
봉국사,3,3,127.1353834,37.45071539,6
봉녕사,12,11,127.0374644,37.29148204,23
봉덕칼국수,12,12,127.0097496,37.43989747,24
봉덕칼국수 의왕본점,1,5,126.9656507,37.33559403,6
봉땅,5,5,127.1062841,37.50973779,10
봉림원,4,3,127.4077172,37.72788186,7
봉선사,19,18,127.183749,37.74709015,37
봉선사 일주문,4,3,127.1862141,37.74689348,7
봉선사동종,3,3,127.1834313,37.74710867,6
봉수대공원 주차장,3,3,127.0915282,37.60662444,6
봉수육,5,5,126.9699307,37.29895915,10
봉순게장 부천점,2,3,126.8133213,37.50978406,5
봉순네 본점,4,4,127.133118,37.60828862,8
봉순대,5,5,127.3638622,37.04534521,10
봉식당,5,5,126.7371771,37.39873558,10
봉은사,42,43,127.0472732,37.52658633,85
봉은사로 가로수길,5,5,127.0405045,37.5085884,10
봉은사역 9호선,17,16,127.0602339,37.51425545,33
봉이밥,5,5,126.8278731,37.56895314,10
봉이밥 웨스턴돔점,3,4,126.7726406,37.65477603,7
봉이전,5,5,126.9527067,37.48260358,10
봉천막국수 곤지암점,2,2,127.3494362,37.34709187,4
봉추찜닭 강남대점,4,4,127.1271657,37.27191036,8
봉추찜닭 롯데월드몰점,2,3,127.1040931,37.51371677,5
봉추찜닭 신림점,2,1,126.9276883,37.48349193,3
봉탁항아리바비큐 불쭈꾸미 삼청동 본점,3,3,126.9824173,37.58461947,6
봉피양 마포점,4,5,126.9428908,37.54012296,9
봉할매 김치찌개불백전문점 동대문종합시장점,4,3,127.007317,37.57010733,7
봉화산역 6호선,5,5,127.0913601,37.61735084,10
봉황각,5,4,127.0062015,37.66033599,9
부개도서관,5,5,126.7395183,37.49098998,10
부개서초등학교 버스정류정,5,5,126.734288,37.489936,10
부개역 1호선,14,14,126.7407301,37.48847704,28
부개역푸르지오아파트,10,10,126.7377658,37.49029414,20
부개역푸르지오아파트 101동,5,5,126.738633,37.49128536,10
부곡도깨비시장 공영주차장,3,3,126.9503588,37.31934659,6
부기우기,7,8,126.9890065,37.53921003,15
부띠끄경성,4,4,126.9811793,37.5822803,8
부라타랩,3,3,127.0981404,37.51131078,6
부락산,5,5,127.0785747,37.06940597,10
부모님 주말농장(양파 추가 채취),5,4,129.3357288,35.53959177,9
부민옥,4,4,126.9803182,37.56750384,8
부부막창꼼장어,4,4,127.1948439,37.89671745,8
부부식당,5,5,127.004302,37.58021304,10
부부식탁,4,4,126.7612919,37.71576048,8
부뷤밥 배곧신도시점,4,4,126.726981,37.37759616,8
부산명가밀면 오산점,5,5,127.0775786,37.13691993,10
부산미도어묵,5,5,126.9644215,37.52966539,10
부산밀면,9,8,127.0772713,37.52167635,17
부산서부버스터미널,4,4,128.9825254,35.16323947,8
부산아지매국밥 방이점,5,5,127.1083474,37.51463918,10
부산역,172,171,129.0414192,35.11510918,343
부산역 부산1호선,3,3,129.0393443,35.11454124,6
부산종합버스터미널,10,7,129.0954724,35.28477323,17
부손항아리막국수,10,10,127.4727185,37.6780607,20
부송국수 원효점,3,3,126.9539798,37.5323792,6
부어치킨 광주중대동점,5,5,127.2218707,37.40140003,10
부엉이돈가스 김포현대아울렛점,4,4,126.7839246,37.59791624,8
부엉이돈가스 남산서울타워점,3,3,126.9882261,37.55131578,6
부영각,5,5,126.9395035,37.54251073,10
부원면옥,1,2,126.9776044,37.55842131,3
부자숯불갈비,4,4,127.2223785,37.94441487,8
부자오리,4,3,127.0796567,37.58700495,7
부잣집설렁탕,3,4,127.1733464,37.34039886,7
부찌식당 부대찌개 본점,2,2,127.0339952,37.26344452,4
부천 국제애니메이션페스티벌,3,3,129.3268875,35.78681476,6
부천가마솥순대국,4,4,126.7655901,37.48629449,8
부천대학교,5,5,126.7793323,37.48865997,10
부천무릉도원수목원,5,5,126.81862,37.50288702,10
부천시민회관,4,4,126.7704236,37.48821772,8
부천식물원,5,5,126.8157147,37.50515666,10
부천역 1호선,19,19,126.7830817,37.48398888,38
부천역북부광장,7,7,126.7827812,37.48470553,14
부천자연생태공원,23,20,126.8173965,37.50374289,43
부천자유시장,4,4,126.7797312,37.48373761,8
부천제일시장,5,5,126.8097889,37.52813003,10
부천종합터미널,5,5,126.7566676,37.50415599,10
부천중앙공원,9,9,126.7653157,37.50028836,18
부천평안교회,4,4,126.8037614,37.47275523,8
부천호수식물원 수피아,5,5,126.7468111,37.50454883,10
부천활박물관,5,5,126.7974205,37.5008163,10
부촌육회,4,5,126.9999321,37.57037786,9
부촌육회 2호점,5,5,127.0002219,37.57062653,10
부추삼겹살,4,4,127.0043383,37.26831315,8
부탄츄,7,7,127.1040931,37.51370596,14
부티크646오피스텔,3,3,126.7088623,37.40263373,6
부티크호텔K 종로점,4,4,126.9882685,37.56924472,8
부평4동성당,5,5,126.7272553,37.49872897,10
부평구청역 7호선,5,5,126.7214397,37.5074335,10
부평굴포누리아이뜨락 생태공원,3,3,126.7304384,37.50921313,6
부평깡시장,5,5,126.7272718,37.49793973,10
부평깡시장 공영주차장,5,5,126.7269054,37.49856868,10
부평모두몰 10번출구,4,4,126.7243746,37.49114303,8
부평문화의거리,20,20,126.7242776,37.49416297,40
부평역 1호선,38,37,126.7243311,37.48944904,75
부평역 인천1호선,3,2,126.7234547,37.49037683,5
부평역사박물관,8,8,126.7378114,37.51216339,16
부평역지하상가,15,16,126.7234383,37.49116247,31
부평종합시장,4,4,126.7266122,37.49647857,8
부평중앙지하상가,10,10,126.7243085,37.48944539,20
부평평리단길,8,9,126.7235295,37.49463696,17
부평풍물대축제,8,7,126.7219276,37.50702379,15
부평현대더로프트오피스텔,6,6,126.7279736,37.4896503,12
북강릉농협하나로마트 연곡점,5,5,128.8387524,37.85854282,10
북극해고등어 본점,5,5,127.0441237,37.19250531,10
북극해고등어 안성공도점,3,4,127.1953055,37.00737456,7
북극해고등어 용인신봉점,5,4,127.0541789,37.33371877,9
북문유치회관,4,4,127.0110971,37.29033412,8
북서울꿈의숲,8,8,127.0415725,37.6236047,16
북수동성당,4,4,127.0172529,37.28293766,8
북수원온천,9,9,126.9716404,37.29945334,18
북스리브로 수원점,4,4,127.0006809,37.26550918,8
북악산,5,5,126.9737306,37.59299979,10
북악산 청운대쉼터분기점,3,4,126.9828254,37.59216624,7
북악스카이웨이,10,10,126.9770843,37.60085082,20
북악팔각정,20,20,126.9806581,37.60159027,40
북앤레스트,5,3,127.0565531,37.51095058,8
북울산역,6,6,129.37194,35.61482295,12
북창동순두부 강남고속터미널점,1,3,127.0061865,37.50578318,4
북창동순두부 서울역점,5,5,126.9708258,37.55343822,10
북창동순두부 안양범계점,5,5,126.9525489,37.39060621,10
북창동순두부 인사동점,1,3,126.986004,37.57298271,4
북창동순두부 홍대점,3,3,126.9209826,37.55522188,6
북촌,9,8,126.9780589,37.57992599,17
북촌김치재,8,9,126.9861989,37.57771295,17
북촌단청공방,4,4,126.9893487,37.58302914,8
"북촌로,북촌한옥마을",4,4,126.9833846,37.58291853,8
북촌마을서재,12,12,126.9877008,37.5803242,24
북촌맛집쭈꾸미,4,4,126.9872752,37.57940874,8
북촌문화센터,6,7,126.9864285,37.57908069,13
북촌사진관,4,3,126.9830866,37.57881716,7
북촌손만두 동대문역사문화공원점,4,4,127.0077649,37.56722952,8
북촌손만두 양재역점,3,3,127.0347685,37.48336928,6
북촌전망대,5,5,126.9827596,37.58304818,10
북촌전시실,4,4,126.9830729,37.579574,8
북촌주민사랑방,3,3,126.9876781,37.58032419,6
북촌한옥마을,163,172,126.976767,37.54408712,335
북카페눈,5,5,126.6871929,37.70754511,10
북파크라운지,5,5,127.0025165,37.54095846,10
북한강,18,16,127.3754948,37.66656252,34
북한강 포시즌 수상레저,4,4,127.5387905,37.77702004,8
북한강막국수닭갈비,5,5,127.3389844,37.59718034,10
북한강막국수닭갈비 2호점,4,4,127.3352151,37.59498369,8
북한강철교초소쉼터,5,5,127.3196958,37.55004385,10
북한강포시즌연수원,4,4,127.5384713,37.7768305,8
북한산,5,5,126.9779913,37.65865287,10
북한산 대남문분기점,4,4,126.9743785,37.63196319,8
북한산국립공원,10,10,126.9908642,37.67041237,20
북한산국립공원 북한산성탐방지원센터,5,5,126.9496443,37.65511232,10
북한산국립공원 사패산코스,5,5,127.0064696,37.71967072,10
북한산국립공원 회룡탐방지원센터,4,5,127.0359794,37.72324947,9
북한산둘레길 1구간소나무숲길,6,9,127.0090211,37.65888883,15
북한산둘레길 2구간순례길,4,4,127.0046367,37.64687898,8
북한산둘레길 마실길9구간,3,3,126.9405688,37.6429214,6
북한산아이파크아파트,3,3,127.0436316,37.65790985,6
북한산회정식,4,5,126.9583209,37.67861778,9
분당서울대학교병원,3,3,127.123217,37.35190656,6
분당어린이공원,5,4,127.1312305,37.37909632,9
분당중앙공원,25,26,127.1244309,37.37759355,51
분당중앙공원 잔디광장,10,10,127.1219717,37.37892241,20
분더버거,5,5,127.1292233,37.53560071,10
분분,4,4,126.9909693,37.2117236,8
불고기 랩 9222,5,5,126.9892527,37.57388765,10
불고기브라더스 도시락점방 롯데월드점,2,3,127.0986285,37.51091394,5
불고기브라더스 도시락점방 스타필드코엑스점,5,5,127.0598006,37.51129046,10
불고기앤비빔밥,4,4,126.6993601,37.78746534,8
불광근린공원,3,3,126.9299767,37.61907911,6
불광역 3호선,5,5,126.9303158,37.6100478,10
불란서다방,5,5,126.6882198,37.34615552,10
불란서찐빵 대부도본점,1,1,126.5747271,37.2869937,2
불암산,3,3,127.0952726,37.66367185,6
불타불닭,4,4,126.867194,37.48679747,8
불탄소가든,5,5,127.1218664,38.06208622,10
붉은가마솥 와우소문난감자탕,5,5,127.0886061,36.99010588,10
붕붕펜션,4,4,127.4830351,37.89535787,8
뷰66 양주스퀘어점,3,3,127.1036858,37.81674209,6
브라보명품찹쌀꽈배기 수원방화수류정점,2,2,127.0192953,37.28847152,4
브라운도트 인천송도점,12,12,126.6514665,37.41618022,24
브라운도트 인천주안역점,3,3,126.6821332,37.46249937,6
브라운도트 포천송우점,6,6,127.1460495,37.82852313,12
브라운도트호텔 성신여대점,3,3,127.0173154,37.59395739,6
브라운도트호텔 종로점,12,12,126.9896311,37.57129642,24
브라운래빗 서울숲점,4,4,127.0413624,37.54684378,8
브라운스마일,4,4,127.5332407,37.51180845,8
브라운스톤돈암아파트,5,5,127.0177919,37.59787123,10
브라운핸즈 부산점,5,5,129.0391302,35.11633637,10
브라이튼하우스,5,5,126.9944271,37.52847949,10
브런치빈 동탄점,5,5,127.0734532,37.20034793,10
브런치빈 별내점,4,4,127.1268148,37.64460351,8
브런치빈 송도직영점,19,19,126.6459308,37.39396904,38
브런치빈 양주옥정점,2,4,127.0921316,37.81897345,6
브런치빈 운정점,1,1,126.7600509,37.71443534,2
브런치카페37.5 영종하늘도시점,5,5,126.5622269,37.486007,10
브레디 포스트,10,11,126.9702564,37.53100769,21
브로어스101 가평점,3,3,127.515811,37.82426964,6
브로트아트,5,5,126.492769,33.50707896,10
브론즈윅,4,6,127.0551345,37.53829217,10
브루다 양주,14,14,126.9567743,37.77869079,28
브루다 인사동,5,5,126.9832692,37.57218227,10
브루클린더버거조인트 롯데월드몰점,3,4,127.1040942,37.51364649,7
브루클린더버거조인트 여의도점,3,3,126.9248434,37.52429398,6
브루클린커피,4,4,126.9289279,37.51295288,8
브루클린커피 대학로점,6,6,127.0036455,37.58227453,12
브룩스펜션,5,5,127.5247726,37.8578179,10
브릭12,3,3,126.4260174,33.23799399,6
브릭캠퍼스 강릉,2,2,128.9421598,37.77578231,4
브알라 Cafe 대학로,3,4,127.0030523,37.58269261,7
블랑제리11-17,4,4,127.1231974,37.53705326,8
블랑제리보네르 본점,3,3,126.7545185,37.50736452,6
블랙랩,5,5,127.0490536,37.506703,10
블랙밤부,5,5,127.3589191,37.62417797,10
블랙베어도넛 망원점,4,4,126.9116786,37.55622441,8
블랭크,5,5,126.9809965,37.48612275,10
블럭593,10,10,127.1087777,37.51493792,20
블레스롤 광교카페거리점,7,7,127.0521315,37.29379035,14
블레스롤 수원터미널점,4,3,127.0183648,37.25048287,7
블루가이 신촌점,2,2,126.9371274,37.55846076,4
블루누드,3,3,126.9998144,37.53579395,6
블루마린관광호텔,10,10,126.5981433,37.47559019,20
블루문,5,5,127.3603421,37.64347085,10
블루밍 커피,4,4,126.6792743,37.6392522,8
블루박스,4,5,126.6887023,37.71488346,9
블루보틀 광화문 카페,20,25,126.9788688,37.56948218,45
블루보틀 삼청 카페,20,21,126.9808447,37.58015029,41
블루보틀 성수 카페,14,15,127.0456429,37.54808828,29
블루보틀 여의도카페,4,4,126.9282989,37.52604137,8
블루보틀 한남 카페,12,12,127.0039771,37.53720125,24
블루스퀘어,21,22,127.0025482,37.54086115,43
블루스퀘어 마스터카드홀,10,10,127.002478,37.54086836,20
블루스퀘어 신한카드홀,21,21,127.0023196,37.54070618,42
블루스톤 스포츠,5,5,126.9680199,37.50685662,10
블루아이즈,3,4,126.6484777,37.39510292,7
블루오션레지던스호텔,1,1,126.5635148,37.48735336,2
블루힐모텔,6,6,126.9070341,36.92101967,12
블뤼떼,5,5,127.0008146,37.53519208,10
블리스모텔,3,3,126.9775385,37.40060413,6
비공,4,4,127.1108636,37.51275735,8
비다벨로 오산직영점,3,3,127.0588227,37.16888318,6
비담,8,8,126.9854522,37.58106996,16
비둘기낭폭포,63,68,127.2169203,38.07977658,131
비룡주유소,4,4,127.4183718,37.12379587,8
비룸스튜디오 송리단길점,5,5,127.1101521,37.50962613,10
비반트,5,5,127.052969,37.59282234,10
비밥돈까스,4,4,126.7045203,37.729423,8
비봉,4,4,126.9563057,37.62566179,8
비봉산전망대,5,5,126.9370811,37.41404716,10
비비드펜션,3,3,127.4397222,37.9838889,6
비빔밥의정석,2,2,127.6440497,37.30192114,4
비사벌 전주콩나물국밥,5,4,127.0450556,37.54633426,9
비사벌전주콩나물국밥 종로점,5,5,126.9896812,37.56916647,10
비스타워커힐 서울,85,83,127.1111154,37.55436172,168
비스타워커힐서울 명월관,2,2,127.1104422,37.55294418,4
비스타워커힐서울 피자힐,19,19,127.1091874,37.55392743,38
비스타호텔,4,4,127.0419629,37.18745569,8
비스트로누,5,5,126.9987606,37.49910869,10
비스트로사랑방,2,2,126.9211748,37.54900873,4
비스트로수방,4,4,126.9839614,37.5643473,8
비스트로주라,6,7,126.9646049,37.567274,13
비아김밥 평촌점,5,5,126.9653746,37.39621502,10
비어썸,4,3,127.0755902,37.62652143,7
비어킹,5,5,126.7528584,33.38870699,10
비엔나커피하우스협동조합 상암팬엔터점,5,5,126.8870588,37.58161149,10
비엣남,9,9,126.9186239,37.52520167,18
비엣콴,4,4,126.9862077,37.57915454,8
비옥,3,4,126.92816,37.55639326,7
비온카페,4,4,126.9277502,37.55540642,8
비욘더팜,4,4,127.1612703,37.48898213,8
비즈,7,8,126.9885588,37.57324157,15
비즈웰종로오피스텔,8,9,126.9887466,37.5745201,17
비츠비츠,4,4,126.9235358,37.55521996,8
비터버터,3,3,126.926185,37.5623233,6
비테스코 테크놀로지스 코리아,3,3,127.4171293,37.30016513,6
비트로드,1,3,126.9138939,37.55481328,4
비트포비아 던전101,5,5,126.923488,37.55099785,10
비파티세리 공덕점,5,5,126.9551195,37.54861746,10
비파티세리 신세계센트럴시티점,5,5,127.004128,37.50467864,10
빅 스트로우 북촌점,5,4,126.984599,37.57944446,9
빅스타코인노래연습장,5,5,127.1387303,37.41122539,10
빅토리스낵,4,4,126.7527997,37.48769111,8
빅토리아GC,4,4,127.6332783,37.17908046,8
빅토리아레이블,4,4,127.1080871,37.51298698,8
빅토리아모텔,3,3,126.8330792,37.63214703,6
빅토리아베이커리,4,5,126.9730653,37.57900631,9
빅트리,5,5,126.8405586,37.38754568,10
빈솔트,1,3,126.5520904,37.28117604,4
빈스앤베리즈 서울역1호점,9,8,126.9708832,37.55435815,17
빈체로 안산점,1,2,126.8332267,37.31814563,3
빈투바로스터리카페,10,10,127.207733,37.28101223,20
빈티지원,5,5,126.9703009,37.17210992,10
빈티지패션팩토리 광명점,5,5,126.8776204,37.47068608,10
빈티지패션팩토리 용인본점,6,7,127.2437995,37.34702516,13
빈팩토리커피랩,3,3,127.1390613,37.61788991,6
빌라노빌레,3,4,127.5406125,37.84386568,7
빌라라온,5,5,127.3562698,37.74914557,10
빌라커피,10,10,126.9849048,37.54469667,20
빌리엔젤 대학로점,3,3,127.0035639,37.58157897,6
빌리엔젤 여의도삼성생명점,2,3,126.9248627,37.5243021,5
빌리프성형외과의원,4,4,127.0285656,37.49783302,8
빕스 일산점,4,4,126.775379,37.6553507,8
빕스 합정역점,3,4,126.9117347,37.54989404,7
빛의시어터,21,22,127.1103171,37.55563197,43
빛의시어터 기념품 샵,4,4,126.8374248,33.32751092,8
빠레뜨한남,4,4,127.0024802,37.53729679,8
빠레뜨한남 김포라베니체점,3,4,126.6790298,37.63919135,7
빠레뜨한남 석촌호수점,4,4,127.1087355,37.51080415,8
빠레트한남 석촌호수점,4,5,127.1087287,37.51079695,9
빠르끄,5,5,126.7966983,37.67756787,10
빠리가옥,2,4,126.9902512,37.57328677,6
빠스타,5,5,127.0394801,37.47094378,10
빠이762,5,5,126.9851806,37.54626624,10
빠체펜션,4,4,126.533826,37.23390931,8
빨간떡볶이샵,2,2,126.9925297,37.42828173,4
빨간오뎅,4,4,126.2636324,33.41588987,8
빵공원,12,13,127.000599,37.45220933,25
빵굽는쉐프의꿈 도당점,5,5,126.7942626,37.51990129,10
빵나무,5,5,126.9212834,37.55756828,10
빵명장,3,3,127.0838332,37.78820108,6
빵명장 본사직영점,10,10,127.2351181,37.92439108,20
빵명장 여주점,3,4,127.6490554,37.30009356,7
빵명장 여주점(베이커리카페),4,4,127.6490554,37.30009356,8
빵빵해요,4,5,127.5278951,37.46517969,9
빵사부식빵공방 모란점,4,4,127.1295241,37.43205654,8
빵선생 샹그리나 파라다이스,9,10,126.7892679,37.60166321,19
빵을요리하다,4,4,126.8853117,37.64296351,8
빵의정석,4,5,127.0435982,37.54642671,9
빼꼼생선구이정식,4,4,126.7481931,37.67192787,8
빽다방,3,3,128.9168269,37.79672551,6
빽다방 고속터미널역점,3,3,127.0036961,37.50612206,6
빽다방 수유역점,3,3,127.0269653,37.63875182,6
빽다방 신사사거리점,3,3,127.0192327,37.51577572,6
빽다방 양평로데오점,5,5,127.4920523,37.49032544,10
빽다방 이태원점,4,4,126.9918641,37.53379885,8
빽다방 인천신포시장점,3,3,126.6257018,37.47177935,6
빽다방 인천연안부두점,9,9,126.6058862,37.45428225,18
빽다방 종로관철점,4,4,126.9845355,37.56900733,8
빽다방 홍대입구점,3,3,126.9236653,37.55476414,6
빽투더레트로,3,4,126.6201746,37.47385745,7
뺑드에코,5,5,127.054065,37.54271207,10
뺑오르방 신봉점,5,5,127.0695397,37.32990208,10
뻘다방,9,9,126.7778612,37.26174262,18
뽀로로파크 일산킨텍스점,3,5,126.7418706,37.66469556,8
뽕나무누릉오리백숙,4,4,126.8346951,37.5072283,8
뽕나무칼국수,2,2,126.783615,37.59065009,4
뽕잎사랑 역곡점,4,4,126.8116722,37.48458933,8
쁘띠속눈썹,5,5,126.9841997,37.5616894,10
쁘띠우스베이커리,3,3,126.9803039,37.48451073,6
쁘띠프랑스,43,57,127.4905368,37.71499518,100
삐에스몽테제빵소,8,7,126.9766605,37.24525863,15
사계절진빵,3,3,126.2987822,33.24902672,6
사계진미숯불닭갈비,3,3,126.9846281,37.56966327,6
사과깡패,3,3,127.2445678,37.98254067,6
사나사계곡주차장,4,5,127.5003241,37.52969934,9
사누끼우동카에,5,5,126.698531,37.71538967,10
사담,4,4,126.9555903,37.47988005,8
사당역 2호선,26,26,126.9815586,37.47656223,52
사당역 4호선,8,8,126.9816985,37.47759121,16
사당역포차,3,3,126.980885,37.47568454,6
사또오리철판구이,5,5,127.7440729,34.73864708,10
사랑경복궁,4,3,126.9757281,37.57858162,7
사랑방 참숯화로구이,5,5,126.9817892,37.54640813,10
사랑방칼국수,4,4,126.99133,37.56326688,8
사랑채,6,7,127.5149512,37.81593602,13
사랑채숯불갈비,3,3,127.0866759,37.79210649,6
사러가,3,3,126.9296518,37.5671025,6
사릉역 경춘선,5,5,127.1769262,37.65112428,10
사리골참치거리,5,5,126.8306412,37.31149233,10
사마르칸트,4,4,127.0058088,37.56514834,8
사맛디커피실록,14,14,127.0193652,37.28827508,28
사발,5,5,126.9724198,37.57349208,10
사비나미술관,4,4,126.9292775,37.63012118,8
사심 행리단길 직영점,3,4,127.0129346,37.28652795,7
사암오리구이,3,3,127.306348,37.18158237,6
사오마이,5,5,127.0106339,37.57236407,10
사우스스프링스CC,4,4,127.4513623,37.17569619,8
사운즈한남,2,3,127.002062,37.53392886,5
사위식당 성수점,5,5,127.0526382,37.54439488,10
사유,9,9,127.0019212,37.53803022,18
사유집,3,3,126.9223871,37.56507071,6
사육신역사공원,10,10,126.9486071,37.51386318,20
사이공리,5,5,126.9400037,37.51125342,10
사이공윤다이,4,4,126.8267101,37.56866492,8
사이숲,13,13,126.7847548,37.05421638,26
사직단,5,5,126.9676599,37.57565326,10
사직커피,5,5,126.5158089,33.25582063,10
사케도로보,4,4,127.0148579,37.28370927,8
사토루 더 서촌,1,3,126.9709599,37.57832827,4
사토시,2,3,127.0358962,37.52678028,5
사트레봉 청평호수점,13,14,127.4871589,37.70211186,27
사푼사푼 강남역점,4,4,127.0288266,37.49435507,8
산골항아리바베큐,5,5,127.0402307,37.36094714,10
산낙지갯마을,4,3,127.0975453,37.4850884,7
산다미아노,5,5,126.9700631,37.56757737,10
산동만두공갈빵,4,4,126.6265127,37.47147737,8
산동주방,1,2,126.6194137,37.47587325,3
산두부집,5,5,127.0092753,37.66200801,10
산들래자연체험학교,4,3,126.8949003,37.21093485,7
산들마을5단지동문굿모닝힐아파트,3,3,126.7754155,37.68160168,6
산들바람팬션,4,4,127.6905527,37.52775724,8
산들소리,5,5,127.1015513,37.65107359,10
산들소리수목원,4,4,127.1015513,37.65107359,8
산리오러버스클럽,4,4,126.9219746,37.55142754,8
산머루농원,5,5,126.9580597,37.96034969,10
산머루농원캠핑장,5,5,126.9608657,37.95848212,10
산본시장,9,8,126.9382423,37.37002742,17
산본역 4호선,3,3,126.9330463,37.35801931,6
산비탈,3,3,127.3047068,38.07033117,6
산성역 8호선,6,6,127.1499419,37.45688147,12
산수가장어,4,4,127.1571217,37.28988796,8
산수갑산 을지로점,4,4,126.995297,37.56537904,8
산애로,5,5,127.2496125,37.54690254,10
산앤들,5,5,127.0046618,37.39477115,10
산운마을2단지월든힐스,10,10,127.0651873,37.39338012,20
산장관광지,10,10,127.4119155,37.75431234,20
산적 안암고대점,5,5,127.0301043,37.5840403,10
산정랜드,4,4,127.3239016,38.06908343,8
산정캠프,10,10,127.3229814,38.05470373,20
산정호수,73,75,127.3210272,38.0716319,148
산정호수 가족글램핑장,4,4,127.3167545,38.06602898,8
산정호수 명성산억새꽃축제,14,14,127.3220949,38.07080734,28
산정호수 빵명장,33,32,127.3252995,38.07594454,65
산정호수둘레길,14,13,127.3196927,38.06769313,27
산정호수베이커리카페,5,5,127.3250549,38.06703336,10
산정호수빵명장,3,3,126.944559,37.04480711,6
산정호수조각공원,3,4,127.3228361,38.06934943,7
산정호수폭포,2,2,127.3167095,38.065995,4
산차이나,4,4,126.9442254,37.93568619,8
산천초가고고씽펜션,2,2,126.9399587,37.77563095,4
산촌 원주점,5,5,127.9625535,37.32635855,10
산촌식당,4,3,127.5242305,37.804799,7
산촌신쭈꾸미,4,4,126.8771359,37.44416248,8
산토리니,4,4,127.2679596,38.02617653,8
살레살레 아이스크림할인점 상동서해점,5,5,126.7506606,37.50396416,10
삼각백빈건널목,4,4,126.9600775,37.52466164,8
삼각지역 4호선,4,4,126.972923,37.53443934,8
삼각지역 6호선,5,5,126.974054,37.5356073,10
삼거리식당,3,3,127.0039955,37.5648637,6
삼거리푸줏간,5,5,126.5708889,33.24491119,10
삼고집,2,3,126.5315261,33.50634441,5
삼고집 파주점,11,9,126.6859651,37.79365422,20
삼국유사군위휴게소 상주방향,5,5,128.6973218,36.0792728,10
삼국지벽화거리,6,6,126.6201389,37.47465022,12
삼대냉면,5,5,127.099579,37.59626644,10
삼대째손두부,10,10,127.1572686,37.4750634,20
삼덕공원,6,6,126.9172943,37.39824549,12
삼동소바,5,5,127.0986617,37.30362526,10
삼미당,7,8,126.7240805,37.49363993,15
삼미당막국수,4,4,127.1937423,37.27776699,8
삼미분식,5,5,127.4404351,37.28105993,10
삼미상사 장안킹셀프주유소,5,5,127.0648293,37.57001948,10
삼방매,5,5,127.1088339,37.51001478,10
삼백집 경복궁역점,7,7,126.9733414,37.57611779,14
삼백집 세종청사점,4,4,127.2571337,36.5084959,8
삼부연폭포,4,3,127.3279847,38.14023317,7
삼부자양평해장국,5,5,126.8839097,37.4203421,10
삼부자회활어회포차,2,3,126.9548108,37.39055213,5
삼산주공미래타운1단지아파트,5,5,126.7418783,37.52281497,10
삼산회관 서울교대점,5,5,127.0123933,37.49192522,10
삼삼오오 카페,5,5,127.3923467,36.37515073,10
삼삼이네 신사점,2,3,127.0224199,37.51840248,5
삼삼이네생고깃집 홍대점,10,10,126.9206761,37.54971478,20
삼삼조약돌 숯불닭갈비,4,4,127.4185497,37.73545885,8
삼성골목집 삼성점,5,5,127.0654293,37.50791863,10
삼성럭키아파트_에어비앤비,2,2,126.6751043,37.40773205,4
삼성산성지,5,5,126.929111,37.45684811,10
삼성역 2호선,8,7,127.0630232,37.50882274,15
삼성전자 수원사업장 중앙문,5,5,127.0498611,37.25760916,10
삼성전자서비스 강변테크노휴대폰센터,5,5,127.0958646,37.53601813,10
삼성전자서비스 동탄센터,5,5,127.0746307,37.22250221,10
삼성화재교통박물관,15,17,127.21693,37.3003599,32
삼송역 3호선,12,13,126.8956718,37.65307495,25
삼악산,4,4,127.6604032,37.83969162,8
삼원가든,4,4,127.0326179,37.52484949,8
삼원프라자관광호텔,1,1,126.9226386,37.39814459,2
삼육가 사당역1호점,5,5,126.9829648,37.47742921,10
삼은40,4,4,127.2902226,37.0774713,8
삼정호텔,14,14,127.0311609,37.50588735,28
삼척늘푸른펜션,9,9,129.2642216,37.32435098,18
삼척해상케이블카 용화역,4,4,129.3082554,37.28911647,8
삼천리자전거 미사강변점,4,4,127.1905163,37.55915991,8
삼천리자전거 올림픽점,4,4,127.1341203,37.52305873,8
삼청공원,5,5,126.9836865,37.58958232,10
삼청동거리,35,35,126.9814828,37.58206411,70
삼청동길,8,8,126.9817433,37.5906452,16
삼청동샤브 에피소드수유838점,5,5,127.0232427,37.63661547,10
삼청동샤브 판교아이스퀘어점,4,4,127.0983333,37.41340311,8
삼청동샤브앨리웨이 광교점,4,4,127.0599955,37.27368715,8
삼청동수제비,24,25,126.9819712,37.58459777,49
삼청빙수,9,10,126.9819648,37.58297058,19
삼청화 대학로점,1,1,127.0040213,37.58122576,2
삼촌네보배곱창,5,5,127.141075,37.59978485,10
삼해집,5,5,126.9909172,37.56992701,10
삼화그린아파트,3,3,127.1357497,37.55323855,6
상갈역 수인분당선,3,3,127.1087373,37.26181183,6
상계역 4호선,4,4,127.0734216,37.66072054,8
상구비어 종각점,5,5,126.9865117,37.56946888,10
상국,5,5,126.9888828,37.57956568,10
상도역 7호선,3,3,126.947918,37.50287063,6
상동역 7호선,3,3,126.7531925,37.5057886,6
상동역먹자골목,5,5,126.7506575,37.5039266,10
상동호수공원,25,24,126.745376,37.50418445,49
상동호수공원 분수광장,4,4,126.7453872,37.50488545,8
상록힐스테이트아파트,3,1,126.8112583,37.36668169,4
상명중화요리,5,5,126.9738038,37.83570849,10
상무초밥 구로디지털점,3,3,126.9023291,37.48341242,6
상무초밥 둔산직영점,3,3,127.3778063,36.35467699,6
상무초밥 산본점,3,3,126.9337091,37.3590865,6
상무초밥 수원역점,10,10,127.0052538,37.26794008,20
상봉공감모텔,2,3,127.0903517,37.59554226,5
상봉역,4,4,127.0857467,37.59670978,8
상봉역 경의중앙선,10,10,127.0851511,37.59671381,20
상상의문 분당서현점,4,4,127.1236458,37.38622618,8
상상키즈풀빌라,4,4,127.3640515,37.75147871,8
상생상회,5,5,126.9838253,37.57604221,10
상수역 6호선,13,13,126.9224299,37.54776618,26
상아골계곡오토캠핑장,10,10,127.1272544,37.94441475,20
상암문화광장,5,5,126.8912675,37.58041892,10
상원사,2,2,127.5533681,37.54842313,4
상주활공랜드,4,4,128.158162,36.43092166,8
상진식감,5,5,127.0216419,37.51931444,10
상천네트워크 시흥풀페이주유소,3,3,126.7723787,37.42665003,6
상천루,5,5,126.759314,33.55743886,10
상천역 경춘선,9,9,127.4545157,37.7701784,18
상촌재,3,5,126.9695909,37.58190667,8
상하이,6,6,127.098027,37.51111266,12
새나루마을8단지세종하늘채센트레빌아파트,3,3,127.3224103,36.48961135,6
새들러하우스,12,15,127.0249201,37.51937687,27
새마을금고 IT센터,6,6,126.8505567,37.55611421,12
새마을전통시장,2,4,127.0863658,37.50920803,6
새말어린이공원,3,3,126.8463677,37.55189397,6
새벽다리,4,3,127.000163,37.56933631,7
새벽종 펜션,2,2,127.789325,36.49906977,4
새봄떡국국수 서대문직영점,5,5,126.9685781,37.56739318,10
새서울순두부,5,5,126.9925569,37.42682569,10
새싹동산 청려수련원,19,19,127.1463476,37.20498019,38
새싹보리칼국수,3,3,126.6456677,37.20040305,6
새연카라반리조트 가평현리1호점,5,5,127.3469817,37.84678649,10
새와참새,12,14,127.5085488,37.64384768,26
새우공장 압구정점,4,3,127.0393656,37.52622596,7
새우타워,4,2,126.7336726,37.39396405,6
새장터공원,3,3,126.7297021,37.6079055,6
새절역 6호선,5,5,126.9135807,37.59086005,10
새하네식탁,5,5,126.7564347,37.66606359,10
샌디,8,9,127.0129118,37.28487004,17
샌앤토,4,4,127.0531246,37.27055301,8
샐러드로우앤트라타,4,5,126.9908714,37.57425809,9
샐러드박스 종로구청점,5,5,126.9802863,37.57257644,10
샐러드상점,3,3,127.1182921,37.49452011,6
샐러드하우스,5,5,126.9735899,37.57445461,10
샐러디 과천점,5,5,126.9919954,37.4269581,10
샐러디 구리역점,3,3,127.142771,37.60197492,6
샐러디 서울시청점,5,5,126.9782457,37.56367244,10
샐러디 안양역점,5,5,126.9210932,37.40283969,10
샐러디 용인보라점,5,5,127.1110346,37.25402559,10
샐러디 한강로점,4,4,126.9647271,37.52449012,8
샐러리아,3,5,126.8190242,37.28329974,8
샘뜰정,4,3,127.5238944,37.46885196,7
샘마루공원,5,5,127.8744151,37.37796193,10
샘이플펜션,10,10,127.5625904,37.87328836,20
샘호텔,9,7,127.1422543,37.54110706,16
샛강다리,5,5,126.9186592,37.5187334,10
샛별반점 중식,5,5,127.1642916,37.76998178,10
생각보다맛있는집 본점,5,5,126.954247,37.48379983,10
생명의나무전망대,3,3,126.6887132,37.34855715,6
생명의나무전망대+빨간등대,5,5,126.6887132,37.34855715,10
생선굽는마을,4,4,126.6993555,37.71483227,8
생어거스틴 광교아브뉴프랑점,5,5,127.0498724,37.29019168,10
생어거스틴 성내점,4,4,127.120241,37.52798053,8
생활맥주 서래마을점,4,3,126.9986135,37.49943215,7
생활맥주 에버랜드점,4,4,127.2172497,37.28639236,8
생활맥주 여의도점,3,3,126.9319164,37.5189328,6
생활사전시관,4,6,126.6200996,37.4734932,10
샤갈의눈내리는마을,3,3,127.3043086,37.18974033,6
샤넬 화장품 AK 플라자 수원점,5,5,127.0000947,37.26567858,10
샤로수길,12,13,126.955677,37.47856461,25
샤론농장,5,5,128.3970554,36.99635738,10
샤롯데씨어터,5,4,127.2000502,38.25498519,9
샤브로21,4,4,126.9455695,37.51311309,8
샤브마니아 광릉수목원점,4,4,127.1238861,37.77762091,8
샤브마니아 여주점,5,5,127.6486745,37.30249416,10
샤브소반,5,5,126.7782502,37.67379016,10
샤브향 구로점,4,4,126.864104,37.49917829,8
샤이바나 코엑스점,1,2,127.0587747,37.51119277,3
샵아지트,2,2,127.0450523,37.54642706,4
샵코인노래연습장,5,5,126.8786479,37.46232846,10
샹끄발레르,8,8,126.6447273,37.39292926,16
샹드마르스커피 공릉점,1,3,127.0781085,37.62338886,4
서가앤쿡 KTX서울역사점,9,9,126.9710616,37.5552628,18
서강쇠떡볶이 압구정로데오본점,3,3,127.0376938,37.52679864,6
서관면옥,4,4,127.0172561,37.4939789,8
서달산,10,10,126.9625415,37.49729353,20
서대구고속버스터미널,10,6,128.5614147,35.8902631,16
서대구역,44,43,128.5400518,35.88142838,87
서대문 자연사박물관,14,14,126.9377324,37.57671165,28
서대문독립공원,9,9,126.9553984,37.57440589,18
서대문형무소역사관,53,55,126.9563153,37.57450354,108
서대전역,32,32,127.4033884,36.32252322,64
서던하일랜드,4,5,126.9912941,37.56081617,9
서동진의커피랩 본점,4,5,127.0141389,37.29803226,9
서동진의커피랩 행궁점,13,13,127.0145338,37.28711884,26
서동탄역더샵파크시티아파트,5,3,127.0636067,37.19165036,8
서두산딤섬만두,4,4,127.1118064,37.51238615,8
서둔교회,3,3,126.9832415,37.27039164,6
서래공원,4,3,127.0030444,37.50146569,7
서래냉면,3,3,127.1039936,37.51370965,6
서래오뎅,3,3,126.9989867,37.49920239,6
서리풀공원,4,3,127.0006151,37.49113658,7
서머셋센트럴분당,10,10,127.1212072,37.38655667,20
서머셋팰리스 서울,25,25,126.9810634,37.5749606,50
서문시장,5,5,128.5807734,35.86890863,10
서산공용버스터미널,5,4,126.458549,36.78184662,9
서삼릉,6,7,126.8683444,37.66334313,13
서삼릉 인종인성왕후효릉,4,4,126.8643561,37.66456845,8
서서울농협하나로마트 상암점,5,5,126.8928401,37.57721462,10
서소문성지역사박물관,5,4,126.9697534,37.56070089,9
서양식탁,2,2,127.0557814,37.29427345,4
서여주휴게소충전소 창원방향,3,3,127.5786438,37.27824847,6
서연궁,3,3,127.0592565,37.16929474,6
서영베니스스퀘어,4,5,126.7304872,37.36830925,9
서오릉,27,29,126.9040489,37.62462897,56
서운동산,8,9,127.2028939,37.77247317,17
서운산자연휴양림,5,5,127.3137187,36.94244815,10
서운칼국수,5,5,126.8073316,37.36245496,10
서울 가로수길,5,5,126.5632316,33.25015006,10
서울 강남버스터미널,5,5,127.3797063,37.68399007,10
서울 고종 어극 40년 칭경기념비,3,3,126.9775374,37.57049826,6
서울 선릉과 정릉,37,38,127.0489285,37.50911053,75
서울 의릉,4,4,126.201379,33.36587424,8
서울 한양도성 백악구간,4,5,126.9859956,37.59372718,9
서울 한양도성 성벽,2,4,126.6692389,33.54306157,6
서울 한양도성 순성길,5,5,126.5283034,33.51278396,10
서울가든호텔,4,4,126.9483714,37.54069131,8
서울고등학교,5,4,127.0055628,37.48373557,9
서울고속버스터미널(경부),353,345,127.0069895,37.50607506,698
서울골뱅이북어구이,4,4,126.9892967,37.56687791,8
서울공예박물관,41,44,126.9832909,37.57663679,85
서울공예박물관 어린이박물관,14,15,126.9828957,37.57690433,29
서울과학기술대학교,9,9,127.080279,37.631881,18
서울광장,27,27,126.9779689,37.5656726,54
서울교동초등학교,4,4,126.9881861,37.57495793,8
서울교복,9,11,127.0942307,37.5107157,20
서울교육대학교,2,1,127.0150954,37.48956877,3
서울교육박물관,8,7,126.9832766,37.57980828,15
서울남부터미널,127,124,127.0155534,37.48456901,251
서울놀이마당,3,3,127.0982012,37.50937898,6
서울대공원,91,90,127.0630906,36.91823268,181
서울대공원 내 포장마차,2,2,126.9706069,37.55467884,4
서울대공원 둘레길,10,10,127.0080989,37.43181368,20
서울대공원 서울동물원,10,10,127.0146008,37.42898025,20
서울대공원 스카이리프트,2,3,127.0093248,37.43174511,5
서울대공원 어린이동물원,18,19,127.0146245,37.42890817,37
서울대공원 입구숲가든(팜파스팝업가든),2,2,128.8773206,37.77951443,4
서울대공원 치유의숲,5,5,127.0267475,37.43537174,10
서울대공원 캠핑장,14,14,127.0255622,37.428627,28
서울대공원 테마가든,2,3,127.0151707,37.43132283,5
서울대공원캠핑장 제4야영지,5,5,127.0239886,37.4295232,10
서울대입구역 2호선,11,11,126.9527132,37.48128451,22
서울대학교 관악캠퍼스,13,13,126.951124,37.45978575,26
서울대학교 관악캠퍼스 정문,7,8,126.9484034,37.46635297,15
서울대학교 수원수목원,9,10,126.9827518,37.26229661,19
서울대학교병원,12,12,126.9989958,37.57959773,24
서울대학교병원 암병원,2,3,126.9976,37.57877871,5
서울도서관,12,12,126.9778374,37.56627445,24
서울도시건축전시관,4,4,126.9767054,37.56690492,8
서울돈화문국악당,8,6,126.9906718,37.57722145,14
서울동 갤러리아백화점 이스트점,4,5,127.0400761,37.52848183,9
"서울둘레길 5코스 관악,호암산코스",5,5,126.9429472,37.46014249,10
서울드래곤시티,4,4,126.9627641,37.53181647,8
서울디자인재단 동대문디자인플라자,2,2,127.0097978,37.56704737,4
서울랜드,51,51,127.0187021,37.43390283,102
서울랜드 동문,5,5,127.0239902,37.43444969,10
서울랜드 동문주차장,9,9,127.0255698,37.43444756,18
서울랜드 정문앞광장,4,4,127.0162297,37.43321482,8
서울레코드,4,4,126.9946209,37.57024799,8
서울로 PH,5,5,126.9681527,37.55630721,10
서울로7017,42,44,126.9702972,37.55662311,86
서울로인 강남N점,3,4,127.0323674,37.49993228,7
서울만남의광장휴게소 부산방향,9,9,127.0419001,37.46018487,18
서울메트로미술관,4,4,126.9736732,37.57582414,8
서울명예도로 감고당길,3,2,126.9824665,37.57755568,5
서울미술관 본관,9,9,126.9632266,37.59457642,18
서울브레드 안녕인사동점,3,1,126.983554,37.57446723,4
서울상신초등학교,5,5,126.9049484,37.59788835,10
서울생활사박물관,4,4,127.077015,37.61970184,8
서울석촌동고분군,3,3,127.1021909,37.50232253,6
서울세계불꽃축제,15,15,126.935118,37.52634084,30
서울숲,225,231,127.0287358,37.46121706,456
서울숲 거울연못,4,4,127.0409943,37.54423821,8
서울숲 곤총식물원/나비정원,3,4,127.0391951,37.5414297,7
서울숲 곤충식물원,5,5,127.0392095,37.5414277,10
"서울숲 군마상, 거울연못",4,4,126.4932661,33.46978393,8
서울숲공원 가족마당,7,8,127.0392793,37.54515782,15
서울숲공원 가족마당 무신사 패선 전시회,5,5,127.0374424,37.5443878,10
서울숲누룽지통닭구이,4,4,127.0444042,37.5469598,8
서울숲스테이,17,17,127.0447715,37.54733134,34
서울숲역 수인분당선,8,8,127.0447462,37.5436458,16
서울숲카페거리,28,28,127.043029,37.54644404,56
서울스카이,39,46,127.1025444,37.51267296,85
서울스퀘어,4,4,126.9737347,37.55546164,8
서울스티커샵,3,3,126.9813312,37.58157394,6
서울시립미술관 남서울미술관,3,3,126.9794808,37.47607534,6
서울시립미술관 북서울미술관,9,10,127.0668598,37.64066136,19
서울시립미술관 서소문본관,20,20,126.9737905,37.56410762,40
서울시산악문화체험센터,4,4,126.8799267,37.56944193,8
서울시새활용플라자,4,3,127.0577753,37.55875168,7
서울시원한마취통증의학과의원 구로점,5,5,126.9006264,37.48256315,10
서울시청,4,4,126.9409853,37.58990008,8
서울시티투어버스,16,16,126.976784,37.56881505,32
서울식물원,62,63,126.8350372,37.56939585,125
서울식물원 LG문화센터,3,3,126.3795945,33.43432508,6
서울식물원 기프트샵,3,3,126.8350597,37.56998873,6
서울식물원 식물문화센터,2,2,126.8350349,37.56941927,4
서울식물원 주제원,5,5,126.8335309,37.5677323,10
서울식물원 주제정원,12,12,126.8333117,37.56857352,24
서울식물원 호수공원,5,5,126.8326839,37.57093324,10
서울신라호텔,15,15,127.0051788,37.55595459,30
서울신라호텔 더파크뷰,8,9,127.0051743,37.55590774,17
서울신라호텔 어번아일랜드,5,5,127.0051789,37.55598342,10
서울씨티투어버스,4,4,126.9762476,37.56842211,8
서울아산병원,4,4,127.1079593,37.52632193,8
서울아산병원 현대백화점 멀티플라자,3,3,127.1092337,37.52750378,6
서울안다즈호텔 2층 식당,5,5,127.0289201,37.5254876,10
서울안다즈호텔B2 수영장,5,5,127.0289201,37.5254876,10
서울암사동유적,8,9,127.1302578,37.56054641,17
서울애니메이션센터,6,8,126.9830683,37.55982418,14
서울앤호텔 동대문,7,8,127.0208334,37.57333489,15
서울앵무새,17,16,127.0436038,37.54829898,33
서울약령시장,4,4,127.0368243,37.57839818,8
서울어린이대공원,28,27,127.0802352,37.54997725,55
서울어린이대공원 놀이동산,6,7,127.0837891,37.55147044,13
서울어린이대공원 동물원,22,23,127.0823189,37.5482387,45
서울어린이대공원 서울상상나라,5,5,127.0775642,37.55077552,10
서울어린이대공원 식물원,3,3,127.081061,37.54863961,6
서울억새축제,4,4,126.8868838,37.5685469,8
서울에살기위하여,5,5,127.005838,37.53285834,10
서울여성공예센터 더아리움,5,5,127.0765346,37.61961926,10
서울역,742,733,126.9706069,37.55467884,1475
서울역 1호선,13,13,126.9720924,37.55597934,26
서울역 2층 푸드코트,3,3,126.972317,37.555946,6
서울역 4호선,7,7,126.9726446,37.5530287,14
서울역 공항철도,5,5,126.9697496,37.55332893,10
서울역 스토리웨이 서울2층맞이방직영편,3,3,126.9673538,37.5529875,6
서울역 푸드코트,5,5,126.9706067,37.555187,10
서울역사박물관,29,29,126.9705464,37.57050032,58
서울올림픽공원 케이스포돔올림픽체조경기장,4,4,127.1274078,37.51924411,8
서울올림픽파크텔,21,21,127.1165487,37.52233314,42
서울우리소리박물관,14,16,126.989619,37.57714207,30
서울월드컵경기장,20,20,126.8972325,37.56815993,40
서울웨딩타워,4,4,127.1156152,37.49507688,8
서울윤중초등학교,2,3,126.9229339,37.51985711,5
서울정신건강의학과의원,1,1,126.7014823,37.44484048,2
서울제빵소 본점,5,5,127.1289204,37.51214616,10
서울집,2,2,127.0398999,37.5036232,4
서울창업디딤터,3,3,127.0773,37.6192461,6
서울창포원 입구,5,5,127.0469016,37.68929511,10
서울책보고,12,13,127.1040825,37.52230604,25
서울청년센터 동대문오랑,5,4,127.0465118,37.58063282,9
서울청담초등학교,5,5,127.0451534,37.52830701,10
서울카츠,5,5,126.9950245,37.56114434,10
서울카페,3,3,126.8014989,33.38495973,6
서울커피 파주점,5,5,126.6925406,37.71808792,10
서울큐브이화,4,4,126.9468477,37.55602383,8
서울특별시 교육청과학전시관 남산분관,5,5,126.9809418,37.55459807,10
서울특별시 구로구 공원로8길 49,3,3,126.8917917,37.503988,6
서울특별시 중부공원녹지사업소 서울창포원,9,8,127.0471647,37.68952926,17
서울특별시교육청 남산도서관,2,2,126.9814266,37.55295112,4
서울특별시교육청 정독도서관,5,5,126.9829955,37.58143003,10
서울특별시청,30,30,126.9786523,37.5668242,60
서울페이스트리 연남점,3,3,126.9241663,37.56287974,6
서울페이스트리 행궁점,9,10,127.0152948,37.28589513,19
서울풍물시장,5,5,127.0253929,37.57281863,10
서울한방진흥센터,7,8,127.0376405,37.58057832,15
서울한복카페,3,3,126.9797578,37.57631638,6
서울한양도성 낙산구간2코스 일부,4,4,127.0086358,37.58079664,8
서울한양도성 남산구간 3코스,4,4,126.9908878,37.55116105,8
서울한양도성 흥인지문구간,4,4,127.0100104,37.56546881,8
서울함공원,2,4,126.8978981,37.55315711,6
서울혁신파크,9,9,126.7493107,35.42918572,18
서일사우나,3,3,127.0797454,37.50767376,6
서일중학교,3,3,127.0220794,37.4992616,6
서장대,4,4,127.0102612,37.28075435,8
서정리역 1호선,5,5,127.0528817,37.0565637,10
서정리전통시장,5,5,127.0550772,37.05784223,10
서종가든,4,3,127.3510463,37.60490438,7
서종더김밥,3,3,127.35423,37.62454893,6
서쪽하늘,10,10,126.755066,37.84593929,20
서천휴게소 목포방향,3,2,126.6264004,36.1295753,5
서초경찰서,4,4,127.005281,37.49561087,8
서초면옥 서초본점,1,1,127.0111086,37.49115408,2
서초역 2호선,9,9,127.0076621,37.49184993,18
서촌그책방,5,5,126.9703258,37.57875338,10
서촌도그살롱,5,4,126.9696105,37.575315,9
서촌식당,3,3,126.9699986,37.58147069,6
서촌한옥마을,10,10,126.9731107,37.57872882,20
서축공업기념관,2,4,126.6928704,37.7206187,6
서퍼스파라다이스,5,5,126.6834107,37.32175282,10
서평면옥,4,4,126.9242605,37.49217189,8
서하남휴게소 판교방향 행복드림쉼터,5,7,127.1931726,37.52582407,12
서하남휴게소주유소 판교방향,8,8,127.1931738,37.52582947,16
서해랑 제부도해상케이블카 전곡정류장,9,9,126.6500894,37.18391439,18
서해바다,9,9,126.6532616,37.18619256,18
서현역,5,5,127.1231651,37.3850076,10
서현역 수인분당선,8,8,127.1234315,37.38501543,16
서현역 중심상권 & AK플라자,4,4,126.8988844,37.48317255,8
서현역광장,5,5,127.1215865,37.38368022,10
서화커피,5,4,127.0000226,37.58159344,9
서희테마파크,2,2,127.4815649,37.27671536,4
석계역 1호선,4,4,127.0656895,37.61500553,8
석계역문화공원,5,5,127.0644787,37.61508548,10
석계역한일노벨리아시티오피스텔,8,6,127.0609969,37.61358268,14
석교산,2,2,127.0596945,36.94694565,4
석남사,5,5,127.3070738,36.93958564,10
석남사계곡,5,5,127.3079757,36.93942471,10
석바위칼국수,5,5,126.6901599,37.4588707,10
석성산,3,4,127.1729551,37.27258937,7
석수마애불,4,5,127.0069895,37.50607506,9
석암산수도사,3,3,126.6929138,37.45654247,6
석장리박물관,4,4,127.1896721,36.44752718,8
석죽재물고기나무,3,4,126.6946329,37.78744958,7
석천가든,6,7,127.2267423,37.93096816,13
석촌역 8호선,5,5,127.1070041,37.50541412,10
석촌호(서호)교차로,4,4,127.0972611,37.50656862,8
석촌호수,5,5,126.9168656,33.44886914,10
석촌호수 동호,176,179,127.1058999,37.51162124,355
석촌호수 서호,119,124,127.0991128,37.50768073,243
석촌호수벚꽃축제,3,3,127.0998712,37.50983169,6
석촌호수산책길,120,119,127.1057213,37.51008969,239
석촌호수수변무대,8,8,127.1050785,37.51222834,16
석탄이신의선생기념관,3,3,126.8648132,37.6293919,6
석파정,17,19,126.9626511,37.59502313,36
선감도,5,5,126.6364215,37.22495915,10
선감어촌체험마을,3,3,126.6299223,37.22035091,6
선다래분식,5,5,127.0032309,37.57681993,10
선릉역 2호선,21,21,127.0489628,37.50449737,42
선릉역 수인분당선,5,5,127.0487099,37.50516783,10
선릉역롯데골드로즈,3,3,127.050742,37.5041271,6
선릉을지순대국,4,5,127.0534694,37.50404041,9
선바위메밀장터 본점,28,28,127.0005707,37.45248774,56
선바위역 4호선,8,8,127.0022287,37.45174799,16
선법사,5,5,127.208678,37.51809323,10
선부역 서해선,18,18,126.8099895,37.33440845,36
선산휴게소 양평방향,19,18,128.2491505,36.27806165,37
선산휴게소 창원방향,8,9,128.2507366,36.2742315,17
선산휴게소 환승정류소(상행),3,3,128.2488402,36.27814419,6
선샤인스튜디오,5,5,127.1048191,36.10274483,10
선식당 인천스퀘어원점,4,4,126.6836235,37.40599636,8
선식당 인하대점,3,3,126.6485006,37.44771858,6
선유도공원,31,30,126.9018234,37.54241694,61
선인다원,4,4,126.7575124,37.65984185,8
선인상가,3,3,126.9653344,37.53221369,6
선정릉역 9호선,3,3,127.0440149,37.51032432,6
선창수산,5,5,127.0211587,37.21724729,10
선한목자교회,5,5,127.1271663,37.46624986,10
선희네집용이점,4,4,127.1386204,36.99526807,8
설레다,1,1,127.0178294,37.27927214,2
설레임의원 강남점,5,5,127.0288366,37.49666885,10
설매재자연휴양림,14,15,127.512471,37.55628053,29
설맥 낙원점,2,3,126.9890424,37.5722334,5
설문단팥빵,3,3,126.7998842,37.72671603,6
설문스파랜드,4,4,126.800344,37.72487523,8
설문커피,4,4,126.79953,37.72638207,8
설봉2차푸르지오아파트,10,10,127.4529611,37.28566558,20
설봉공원,36,36,127.4280743,37.27667579,72
설봉산,4,5,127.413039,37.28087486,9
설봉호수,3,3,127.4308349,37.27753798,6
설빙 경기화성동탄카림애비뉴점,3,3,127.1134846,37.1995099,6
설빙 동대문점,10,9,127.0062979,37.56599344,19
설빙 서울혜화대학로점,5,5,127.0033013,37.58271783,10
설빙 석촌호수동호점,7,7,127.1065225,37.5103845,14
설빙 송도센트럴시티점,5,5,126.6533048,37.37441174,10
설빙 수원인계점,5,5,127.0332347,37.26445841,10
설빙 신포점,5,5,126.6250384,37.47105824,10
설빙 충무로점,4,4,126.9950924,37.56124526,8
설악막국수 춘천닭갈비,9,9,127.3420912,37.48329214,18
설악막국수 춘천닭갈비 이천점,5,5,127.4381607,37.16320854,10
설악막국수춘천닭갈비,5,5,127.4862278,37.67760034,10
설악버스터미널,3,3,127.4878816,37.67742233,6
설악숯불닭갈비,2,4,127.4910097,37.71550586,6
설악하우스,8,8,126.6868629,37.3419063,16
설악한우마을정육센터,5,5,127.4923793,37.67702523,10
설화수 북촌플래그십스토어,4,4,126.98485,37.58101313,8
설화수 플래그십스토어,5,5,127.0354941,37.52343408,10
설화수의집 북촌,8,9,126.9848522,37.58100682,17
섬마을게장님,1,2,126.7466133,37.70582997,3
섬말,3,3,126.9700309,37.83904833,6
섬말다방,5,5,129.0526426,35.16388443,10
섬섬옥수 용산역점,5,5,126.9643733,37.52874365,10
섬세이 테라리움,9,9,127.0434872,37.54625736,18
섬스튜디오,4,3,127.2027598,37.56992263,7
섬진강추어탕,6,6,126.8249384,37.48984999,12
섭이랑,4,4,127.5318371,37.46827588,8
성경만두요리전문점 에버랜드점,5,5,127.216038,37.28779389,10
성경만두요리전문점 종로점,5,5,126.9897118,37.56890879,10
성광대도,4,4,126.9871002,37.54389143,8
성균관,3,4,126.9958969,37.58582803,7
성균관대역 1호선,3,3,126.971022,37.300329,6
성균관대학교 명륜당,8,10,126.9958063,37.58618482,18
성균관대학교 인문사회과학캠퍼스,6,7,126.9939675,37.58831649,13
성균관대학교자연과학캠퍼스 의과대학,3,3,126.9725725,37.29196775,6
성남제1공단 근린공원,4,4,127.1542398,37.44622957,8
성남종합버스터미널,10,10,127.1272007,37.41311608,20
성라공원,5,5,126.8434727,37.64605445,10
성미산알루,5,5,126.9078043,37.55927402,10
성복천자전거길,2,2,127.0940879,37.31727786,4
성수김밥 퍼니텅,4,4,127.0476904,37.53983161,8
성수노루,5,5,127.0558792,37.54161561,10
성수다락,4,4,127.0562242,37.53991796,8
성수동거리(젠트리피케이션),5,5,126.5200013,33.5115169,10
성수동구두테마공원,4,4,127.0524145,37.54481214,8
성수동수제화거리,10,10,127.0571871,37.54443871,20
성수동카페거리,14,13,127.0563935,37.54243257,27
성수베이킹스튜디오,15,14,127.0437587,37.54618518,29
성수부두,5,5,127.0542873,37.54342195,10
성수역 2호선,26,26,127.056067,37.54458882,52
성수연방,7,8,127.0569585,37.54139705,15
성수족발,5,5,127.0543164,37.54602763,10
성신여자대학교 미아운정그린캠퍼스,10,6,127.0273072,37.63191236,16
성안셀프주유소,5,5,127.5530188,37.19522345,10
성오볼링장,3,3,127.0031482,37.27806965,6
성우육회,5,5,126.9997962,37.57035263,10
성은교회,5,5,127.1254838,37.63740967,10
성환역,20,20,127.1268868,36.91613679,40
성훈마트,5,5,127.0577683,37.57319645,10
세검정돈까스,8,9,126.964055,37.59557858,17
세계음식특화거리,3,3,126.9945737,37.53500455,6
세계주류,5,5,127.7620441,37.83974087,10
세광양대창 성수점,2,2,127.0574786,37.54387094,4
세라비한옥카페,23,26,127.0444143,38.13041501,49
세라젬웰카페 서울반포직영점,9,9,127.0105518,37.50381868,18
세라젬웰카페 인천도화직영점,4,4,126.6641261,37.46905034,8
세라핌글램핑,8,8,127.5135618,37.62396934,16
세류역 1호선,3,3,127.0137997,37.24387252,6
세모식당,3,3,126.7472757,37.67173129,6
세미원,34,35,127.3242115,37.54074768,69
세미원연꽃문화제,3,3,127.3235571,37.53856906,6
세베크 새솔,5,5,126.8178069,37.2840133,10
세븐모텔,4,4,127.6505069,37.29208632,8
세븐스타코인노래연습장 판교역점,3,3,127.111427,37.3977642,6
세븐일레븐 가평리프레쉬점,4,4,127.4572027,37.81650948,8
세븐일레븐 경복궁점,5,5,126.9798389,37.57790845,10
세븐일레븐 광명한빛점,3,3,126.8832284,37.44755197,6
세븐일레븐 남양주도농역점,3,3,127.162538,37.6083689,6
세븐일레븐 남양주송촌리점,4,4,127.3225919,37.56821532,8
세븐일레븐 대치11호점,5,3,127.0650066,37.50828827,8
세븐일레븐 라마다신설동점,4,4,127.0258107,37.57615942,8
세븐일레븐 부평북부역점,5,5,126.722201,37.49060455,10
세븐일레븐 상암KLID타워점,5,5,126.8879816,37.58226108,10
세븐일레븐 서초페이토점,1,1,127.032415,37.48711004,2
세븐일레븐 설악유명산점,3,3,127.4911799,37.61747577,6
세븐일레븐 수서역점,3,3,127.102867,37.48731568,6
세븐일레븐 수원북문점,5,5,127.0143877,37.28950571,10
세븐일레븐 신내신아점,3,4,127.0947318,37.60641558,7
세븐일레븐 여의아이비피아,3,3,126.9199635,37.53030676,6
세븐일레븐 역삼보브점,5,5,127.0260998,37.5046717,10
세븐일레븐 영등포6호점,3,3,126.9092612,37.51887071,6
세븐일레븐 인천1호부평역사1호점,5,5,126.7234861,37.49044718,10
세븐일레븐 인천소래역점,5,5,126.734349,37.4013314,10
세븐일레븐 인천하버파크호텔점,3,3,126.6197044,37.47206113,6
세븐일레븐 종로가배점,5,5,126.9984118,37.57102206,10
세븐일레븐 천안수신점,4,3,127.2795012,36.72935756,7
세븐일레븐 청계을지로3가점,3,3,126.9894099,37.56707253,6
세븐일레븐 충무퇴계점,3,3,126.9950743,37.56165611,6
세븐일레븐 파주아트팩토리점,2,2,126.6946554,37.72123599,4
세븐일레븐 홍천비발디점,3,3,127.6761375,37.61325798,6
세빛섬,15,15,126.9958885,37.51233177,30
세상마켓,3,3,127.0035277,37.5809735,6
세상만사뼈다귀 태능역점,4,4,127.0756233,37.61894951,8
세상의모든아침 for ME 롯데월드몰점,3,3,127.1044461,37.5137471,6
세상의모든아침 여의도점,5,5,126.9199089,37.52217248,10
세솔메디컬의원,4,4,126.7510855,37.7323965,8
세시셀라 도산공원점,5,5,127.0361637,37.52314916,10
세시셀라 아브뉴프랑점,1,1,127.113781,37.39657982,2
세실마루,3,3,126.9761734,37.56672282,6
세운상가 카페(해피클럽),5,5,126.5266709,33.51807909,10
세운전자상가,23,24,126.9952368,37.56913799,47
세운청계상가,5,5,126.9954225,37.56781173,10
세운청계상가.빈센조 촬영지,3,4,126.9954225,37.56781173,7
세월보건진료소,3,3,127.4941321,37.43747024,6
세이 탄방점,3,3,127.3888548,36.34706177,6
세이브존 화정점,4,4,126.8314112,37.63432504,8
세이스테이,15,15,126.6594517,36.78546796,30
세이지핀치,5,5,126.9689587,37.57747362,10
세인트앤드류스커피,4,5,127.0797313,37.51142195,9
세종국악당,5,5,127.6246759,37.29744419,10
세종대학교,5,4,127.0742595,37.55060285,9
세종마을 음식문화거리,3,3,126.9722738,37.57656984,6
세종문화회관,17,19,126.975721,37.57262064,36
세종문화회관 대극장,13,12,126.9760696,37.57286218,25
세종문화회관 미디어파사드 관람,5,5,126.975721,37.57262064,10
세종문화회관 미술관,3,3,126.9761831,37.57185309,6
세종중앙공원,5,5,127.2747841,36.49127152,10
세종충무공이야기,4,4,126.9761716,37.57253153,8
세종호수공원,4,4,127.2734214,36.49793779,8
세종호텔,5,5,126.9879483,37.56144657,10
세컨드코너,5,5,127.2704011,37.00660729,10
세컨디포레스트,4,4,127.0129964,37.28474839,8
세컨디포레스트 송도점,2,3,126.6335842,37.39373231,5
세컨디포레스트 송리단길점,3,4,127.1108471,37.50924435,7
세탁프리워시 나혜석거리점,4,3,127.0362151,37.26371237,7
세포라 파르나스몰점,4,5,127.0609754,37.50940586,9
섹터커피바,4,4,126.9939154,37.56094247,8
센서리커피 로스터스,4,5,127.0241263,37.54851,9
센시빌리티,3,4,127.03486,37.19026657,7
센이모노,5,5,128.6283938,35.87932399,10
센터마크호텔,29,29,126.9842653,37.57256443,58
센터커피 서울숲점,9,9,127.0416202,37.54655176,18
센터필드,4,4,127.0416472,37.50358205,8
센트럴공원수상택시,5,5,126.6436055,37.39039943,10
센트럴시티지하상가,3,3,127.004257,37.50498678,6
센트럴시티터미널,5,5,126.9017963,33.48598547,10
센트럴시티터미널(호남),231,229,127.0042525,37.50503723,460
센트럴파크,23,23,126.7186969,37.44417663,46
센트럴파크 한의원,10,10,126.6320289,37.39355808,20
센트럴파크역 인천1호선,13,13,126.6349888,37.39284554,26
셀레네호텔,5,5,127.109201,37.515587,10
셀렉토커피 광주경안점,3,3,127.2582381,37.41071481,6
셀리스도넛,3,3,126.9361863,37.55778541,6
셀스스터디룸 홍대점,1,1,126.9230217,37.55765592,2
셜록홈즈 부평점,4,4,126.7249148,37.49431222,8
소고기전병,5,5,126.9979202,37.58370805,10
소극장혜화당,5,5,127.0040258,37.58123657,10
소금집 델리 안국,15,15,126.9862337,37.57945728,30
소나무 양평점,4,4,127.4896298,37.49007151,8
소나무가있는풍경,2,2,127.110607,37.2730587,4
소나무집,5,5,126.6735962,37.16498551,10
소나무집초당순두부,3,3,128.9155074,37.79169871,6
소나무커피,7,7,127.2963727,37.33750561,14
소나무향기 남양주점,5,5,127.3499362,37.62900719,10
소노벨비발디파크 C동,5,5,127.6814064,37.64664104,10
소노캄 고양,29,29,126.7508087,37.66192535,58
소노캄고양 셰프스키친,3,3,126.7507996,37.66192353,6
소노캄고양 웨스트타워,2,2,126.7501178,37.66247169,4
소노휴 양평,39,40,127.5326725,37.46922627,79
소노휴양평 빠띠오,9,9,127.5326354,37.46925617,18
소노휴양평 헬스클럽 및 수영장,5,5,127.5326668,37.4692272,10
소담 선릉본점,4,3,127.0464885,37.5047912,7
소담촌 광명소하점,5,5,126.8819661,37.4482472,10
소담촌 모래내시장역점,4,4,126.7177572,37.45633772,8
소담촌 부천원종점,4,4,126.8051937,37.5236788,8
소담촌 용인수지점,4,4,127.0955522,37.3225243,8
소도호텔,1,1,126.7753104,37.76447632,2
소라네양과점,4,5,127.1264968,37.65752394,9
소래강릉짬뽕순두부,4,4,126.7358448,37.39798837,8
소래산,8,8,126.7788811,37.45221692,16
소래습지생태공원,16,15,126.7473723,37.41241003,31
소래역사관,8,8,126.7374681,37.39820282,16
소래철교,3,3,126.7390418,37.39643671,6
소래포구,30,27,126.7394893,37.39764866,57
"소래포구 근처 어시장 및 산책로, 다리",3,2,126.7375669,37.3975872,5
소래포구 해오름공원,4,4,126.7310682,37.39151008,8
소래포구 해오름광장,10,12,126.7368348,37.39714903,22
소래포구길영호,3,2,126.7391249,37.39852005,5
소래포구역 수인분당선,20,20,126.7334921,37.40094023,40
소래포구전통어시장,4,4,126.7393099,37.39792398,8
소래포구종합어시장,31,33,126.7371851,37.39902663,64
소령원 장단콩 두부마을,4,4,126.9033267,37.77438128,8
소리소시골밥상,5,5,127.1815163,37.65049473,10
소리숲카페,8,8,127.0559406,37.53898105,16
소리천산책로,4,4,126.2894893,33.30591329,8
소마드로잉카페 홍대점,3,3,126.9257421,37.55346623,6
소마미술관,7,8,127.1180062,37.51688604,15
소망교회,5,5,127.0317074,37.52511463,10
소메랑 수원역점,1,1,127.0045931,37.26874924,2
소문난김밥,5,5,126.9693623,37.29904911,10
소문난성수감자탕,14,14,127.0544046,37.54283084,28
소문난성수감자탕 별관,1,1,127.0546061,37.54300014,2
소문난이동갈비,5,7,127.3690603,38.02617474,12
소문난춘천닭갈비 삼산본점,5,5,126.7426295,37.52147953,10
소문난항아리불닭발,4,4,126.7047935,37.46981036,8
소바식당 망원점,5,5,126.9101498,37.55514927,10
소바식당 성수점,7,8,127.0550044,37.54301167,15
소바의온도,6,6,127.0040078,37.58218442,12
소브티하우스,3,3,127.0535585,37.54324929,6
소사벌이즈락볼링장,5,5,127.1130539,37.00087468,10
소사역 1호선,6,6,126.7956443,37.48280033,12
소사역 서해선,8,7,126.7950606,37.48290563,15
소사이어티카페,4,4,126.9216067,37.40000723,8
소새울역중흥S클래스아파트,4,4,126.8031306,37.47102965,8
소설호텔,6,6,127.0138363,37.48637124,12
소소갈비,5,5,127.0932671,37.74018514,10
소소하게 삼청,6,7,126.9813887,37.57809611,13
소소하게 성수점,8,8,127.0468573,37.53932378,16
소소한소품가게&카페,3,2,127.0124949,37.28688841,5
소소한쌈 플러스 소래포구역점,5,5,126.7333677,37.40001911,10
소소한행복,3,4,126.9822579,37.57911978,7
소솜,3,3,126.7446417,37.8357472,6
소수책방,5,5,127.0135131,37.55680628,10
소양강숯불닭갈비,3,3,127.1326195,37.96392039,6
소양강스카이워크,3,4,127.7235629,37.89458007,7
소양골춘천닭갈비,5,5,127.1551935,37.5538525,10
소양댐우미숯불닭갈비,3,4,127.7877105,37.93043127,7
소예다방,3,3,127.0375181,37.58933782,6
소요산,24,24,127.0862928,37.93851287,48
소요산 입구,3,3,127.0746295,37.9470591,6
소요산역 1호선,4,4,127.0611286,37.94889759,8
소우주,5,5,127.031386,37.26492115,10
소울원,2,2,126.7347415,37.80590102,4
소원생고기,5,5,126.5101219,33.25184562,10
소월솥밥,4,4,126.9850179,37.54504807,8
소이연남 라크몽,5,5,127.1051491,37.16689493,10
소이연남마오,4,4,127.038943,37.5251485,8
소장군 부평점,3,3,126.724838,37.49182888,6
소진담,5,5,127.1292206,35.83450993,10
소진담컬쳐,4,5,127.2076108,37.56241072,9
소카모노,8,8,126.9248099,37.56444158,16
소코아 일산점,4,4,126.7888406,37.66305191,8
소테츠프레사 인서울명동,29,29,126.9850142,37.56368071,58
소테츠호텔즈 더스프라지르 서울명동,33,33,126.9787804,37.56205435,66
소파,5,5,126.8818032,37.41816572,10
소풍,4,4,127.3282855,37.55712822,8
소풍농월,4,4,126.7852775,37.8706221,8
소풍모텔,4,4,127.6521042,37.29265418,8
소풍정원,19,18,127.0185958,37.01114532,37
소풍정원 캠핑장,5,4,127.430635,36.31875586,9
소프트랩,4,4,126.9245719,37.56023738,8
소플러스 운정점,4,4,126.7523794,37.719919,8
소피아그린CC,5,5,127.7077457,37.17789317,10
소피텔 레스파스,4,4,127.1062673,37.51380854,8
소피텔 앰배서더 서울,99,99,127.1064031,37.5138805,198
소피텔 앰배서더 서울 수영장,2,2,127.1066848,37.5139952,4
소피텔 앰배서더 서울 수영장(스파),5,5,127.1064031,37.5138805,10
소피텔 앰배서더 서울 클럽 라운지,5,5,127.1064031,37.5138805,10
소피텔 앰배서더 서울 페메종,5,5,127.1064031,37.5138805,10
소피텔 앰배서더 클럽라운지,5,5,127.1064031,37.5138805,10
소하근린공원,3,3,126.8757801,37.43578163,6
소하리원조두루치기&생삼겹 광명일직점,5,5,126.8844773,37.42248334,10
소하염전,5,5,126.9896988,37.57312364,10
소호갤러리카페,4,4,127.1541078,37.04562286,8
소희네묵집,5,5,127.3556001,37.84998257,10
속초고속버스터미널,6,7,128.598776,38.1904606,13
속초그바람에 발산본점,5,4,126.839322,37.55920249,9
속초그바람에 운서점,4,4,126.4988345,37.49615984,8
속초코다리냉면 수원점,4,3,127.001646,37.26763203,7
속초코다리냉면 신세계백화점본점,3,3,126.980981,37.56092488,6
속초횟집,3,3,126.5975736,37.4747341,6
손골성지,3,4,127.0523832,37.34439229,7
손기정체육공원,3,4,126.9653822,37.55607217,7
손수타,4,1,127.0092711,37.55506776,5
손짜장마을,4,4,127.4823567,37.79982806,8
손칼국수&손만두,4,4,127.1047782,37.48750501,8
손커피연구소 인계점,5,4,127.0274232,37.27387848,9
손큰할매순대국 서대문역점,3,4,126.9656222,37.56577777,7
솔가원,3,3,127.0925279,37.76516955,6
솔다람숲힐링파크,5,5,127.4504588,37.8235917,10
솔라리아니시테츠호텔 서울명동,10,10,126.9849601,37.56263915,20
솔로몬마트,4,4,126.8461778,37.52976158,8
솔마루가정백반,5,5,126.6150565,37.47723227,10
솔모로CC,5,5,127.580116,37.1915735,10
솔밭근린공원,5,5,127.0117718,37.65279975,10
솔벗,5,5,126.8492085,37.68413013,10
솔솥 망원점,3,3,126.9081035,37.55525941,6
솔솥 미사강변점,5,5,127.1898219,37.5629353,10
솔솥 성수점,5,5,127.055309,37.54319893,10
솔솥 연남점,5,5,126.9258091,37.56130674,10
솔솥 행궁점,3,3,127.01212,37.28389249,6
솔잎향캠핑파크,5,5,126.8711088,37.3698203,10
솔찬공원,29,30,126.6282104,37.37236048,59
솔트24,10,10,126.9931962,37.57938212,20
솔트가든,5,5,127.1419007,37.92663148,10
솟구쳐차기 큐브점,2,2,126.6606524,37.38116818,4
송계옥 본점,10,10,127.1103492,37.51288578,20
송계옥 성수점,10,10,127.0594279,37.54482504,20
송내근린공원,7,7,126.7647856,37.47747023,14
송내로데오거리,9,9,126.752647,37.49009918,18
송내역 1호선,27,24,126.7531617,37.48764231,51
송내역 1호선(지하철역),5,5,126.7527789,37.4876305,10
송도 센트럴파크,10,10,126.6393808,37.3925126,20
송도 센트럴파크꽃사슴정원,3,4,126.6393808,37.3925126,7
송도누리공원,7,7,126.6556699,37.37864984,14
송도달빛축제공원,33,36,126.6348965,37.40721827,69
송도달빛축제공원역 인천1호선,5,5,126.6260179,37.40692022,10
송도더샵그린워크3차18단지아파트,4,4,126.6380007,37.3987006,8
송도더샵퍼스트파크F14블록아파트,4,3,126.6335758,37.38733325,7
송도랜드마크시티,2,1,126.6295593,37.39949709,3
송도롯데캐슬아파트,5,5,126.6674584,37.3869639,10
송도맥주축제,5,5,126.6352849,37.40632206,10
송도불고기 올림픽공원점,4,4,127.1289172,37.51687643,8
송도센트럴공원 꽃사슴정원,9,9,126.6398154,37.39236659,18
송도센트럴파크,195,198,126.6386297,37.39306396,393
송도센트럴파크 웨스트보트하우스,15,16,126.6304619,37.3939127,31
송도센트럴파크 이스트보트하우스,17,22,126.6435921,37.39037056,39
송도센트럴파크호텔,64,64,126.6376207,37.39036322,128
송도아트포레푸르지오시티오피스텔,8,6,126.6335177,37.39370777,14
송도오라화덕피자,4,4,126.632249,37.39356778,8
송도조개창고,10,10,126.6502177,37.39490985,20
송도코마린웨스트보트하우스,5,5,126.6302928,37.3939957,10
송도콩나물해장국밥,4,4,126.6541365,37.41750084,8
송도타임스페이스,4,4,126.6428696,37.38341342,8
송도한옥마을,27,28,126.6388695,37.39086441,55
송리단길,18,18,127.1104163,37.50932495,36
송산포도휴게소 평택방향,5,5,126.7565771,37.23721851,10
송영선할머니갈비집 본관,4,4,127.3663571,38.0350014,8
송원,6,6,127.3684541,37.76885719,12
송원막국수,6,7,127.5152249,37.82663098,13
송월동동화마을,35,37,126.6203491,37.47801795,72
송이하랑,3,2,126.9848172,37.48601428,5
송정상목장,5,5,127.2011626,37.56025949,10
송정중앙교회,5,5,126.7904969,35.159433,10
송죽부산밀면국밥,5,5,127.010264,37.30134487,10
송죽장,4,4,126.9046988,37.51825084,8
송추가마골 본관,5,5,126.9722667,37.71757377,10
송추가마골 하남미사점,4,4,127.1986783,37.56494707,8
송추기사식당,4,4,126.9721061,37.71626102,8
송탄 부대찌개,3,3,126.536521,33.25045551,6
송탄역 1호선,3,3,127.0542805,37.07571266,6
송탄햄버거,5,5,126.9797401,37.00727491,10
송파관광정보센터,5,5,127.1040815,37.51186432,10
송파구 ~ 광진구 한강 자전거도로,3,3,126.7788811,37.45221692,6
송파구청,5,5,127.1059177,37.51458372,10
송파나루공원,11,11,127.1029126,37.50903619,22
송파나루역 9호선,5,5,127.1126617,37.51101671,10
송파법조타운푸르지오시티오피스텔,5,5,127.1218715,37.4829142,10
송파아이파크오피스텔,4,4,127.1217004,37.47986987,8
송파역 8호선,4,4,127.1121935,37.49971495,8
송해온,5,5,126.6353282,37.38899924,10
송화산시도삭면 2호점,15,15,127.0672443,37.5391959,30
솥뚜껑김치삼겹살,5,5,127.3683521,35.39617157,10
쇠터닭갈비,10,10,127.5371119,37.75712741,20
쇼콜라윰,4,5,126.9225585,37.55248389,9
쇼토,5,5,127.0243084,37.52384777,10
숑스바베큐 파주본점,4,4,126.6861078,37.79319331,8
수내역맛집거리,5,5,127.1123125,37.37813368,10
수노래연습장 홍대본점,5,3,126.9219046,37.55227083,8
수노을대부도맛집,5,5,126.5692166,37.27424218,10
수노을중앙공원,4,5,126.8171656,37.28248595,9
수담 보라민속촌점,8,8,127.0706649,37.25876227,16
수도국산 달동네박물관,14,14,126.6391359,37.47748126,28
수도박물관,3,4,127.0428106,37.53846937,7
수라빔 센트럴시티점,3,3,127.0041122,37.50479217,6
수라전통육개장,5,5,126.6182948,37.70403026,10
수리산 슬기봉,3,3,126.9075635,37.3564673,6
수리산 태을봉,3,3,126.913935,37.37310094,6
수리산 태을봉 등산로 1,3,3,126.913935,37.37310094,6
수리산도립공원,4,4,126.9047248,37.35691145,8
수리산산림욕장 입구,3,3,126.9163006,37.35644897,6
수목식당,5,5,126.9630343,37.50704978,10
수목원프로방스,3,3,127.1357598,37.94139341,6
수목원프로방스 캠핑장,5,5,127.1357598,37.94142944,10
수목촌,4,4,127.1650561,37.76820041,8
수목티,4,4,126.9767867,37.56001232,8
수바코 3호점,5,5,126.9285976,37.55684853,10
수벌산채비빔밥,4,3,127.2787752,37.19242342,7
수봉공원,5,5,126.6625469,37.45948705,10
수봉공원 현충탑,3,3,126.6650239,37.46165291,6
수봉공원인공폭포,2,3,126.6659229,37.46281956,5
수봉산,10,10,126.6648923,37.46149486,20
수블라키아 콩스탕스,4,4,126.6473624,37.39451573,8
수산공원,12,11,126.5460551,37.64247389,23
수서역,145,146,127.1044698,37.48529511,291
수서역 SRT고속철도 3번출구,4,4,127.1048015,37.48480647,8
수석리토성,4,4,127.1760541,37.59077841,8
수성2호 왕새우소금구이,5,5,126.6631559,37.16548611,10
수송게스트하우스,5,5,126.9811273,37.57307213,10
수수카페,15,15,127.3213472,37.55196749,30
수수커피디타워,2,3,126.9789272,37.57107155,5
수수한가 행궁점,4,4,127.0140734,37.2853024,8
수안주유소,8,9,126.9881085,37.32206492,17
수어장대,11,11,127.1765578,37.47985379,22
수연목서,4,4,127.4390522,37.40813631,8
수연산방,5,5,126.9948366,37.59507217,10
수와래,4,4,126.9820034,37.58265884,8
수원KT위즈파크,21,22,127.009772,37.29973025,43
수원갈비스토리,3,4,127.0155879,37.27989958,7
수원공방거리,21,22,127.015335,37.2785877,43
"수원공방거리 ,남문로데오거리",5,5,127.015335,37.2785877,10
수원관광기념품샵,5,5,127.0153276,37.28107457,10
수원광교박물관,10,11,127.0514115,37.29636403,21
수원만두,20,21,127.0173698,37.28152481,41
수원메쎄,4,4,126.9972897,37.26681386,8
수원문화재단,6,7,127.0153355,37.28097005,13
수원버스터미널,11,11,127.0198291,37.25108002,22
수원상공회의소,4,4,127.006072,37.29210412,8
수원성화성빵,5,5,127.0186779,37.28170121,10
수원시 복합문화공간 111CM(구 연초제조장),4,4,126.992602,37.28964872,8
수원시립 아이파크미술관,33,34,127.0158771,37.28268556,67
수원시립미술관,43,42,127.1773202,37.1422156,85
수원시립아이파크미술관 주차장,4,4,127.0158828,37.28266483,8
수원시립아이파크미술관 포니정홀,5,5,127.015408,37.28256668,10
수원시민공원,5,5,126.3763054,33.48279245,10
수원시청역 수인분당선,13,13,127.0308572,37.26192262,26
수원실크로드호텔,2,3,127.0286135,37.26709877,5
수원여자대학교 인제캠퍼스,4,4,126.9640259,37.25244941,8
수원역,209,208,127.0000947,37.26579031,417
수원역 1호선,37,33,127.0000496,37.26568218,70
수원역로데오거리,19,20,127.0017351,37.2676095,39
수원역전시장 A동,1,1,127.0022931,37.26631559,2
수원역지하도상가 12번출구,3,3,127.0009064,37.26755995,6
수원역환승센터,9,9,126.9988726,37.26558847,18
수원역환승센터 주차장,3,3,126.9992559,37.26438108,6
수원영동시장,17,17,126.9135024,36.5229304,34
수원원조갈비,2,5,127.0443183,37.54708327,7
수원월드컵경기장,23,24,127.0369207,37.28649766,47
수원월호텔,5,5,126.970903,37.28141799,10
수원의아침 행궁점,2,2,127.0122644,37.28392942,4
수원전통문화관 예절교육관,11,11,127.0145113,37.28709361,22
수원전통문화관 전통식생활체험관,8,8,127.0142813,37.28759732,16
수원제1야외음악당,8,8,127.0364261,37.25940713,16
수원종합운동장,5,5,127.0113609,37.29775504,10
수원천,22,25,127.0180111,37.28465552,47
수원천 미디어아트쇼,2,2,127.0176284,37.28774915,4
수원탑동시민농장,37,38,126.9981322,37.12276456,75
수원통닭거리,46,41,127.0177528,37.27952444,87
수원팔색길 화성성곽길,60,60,127.0187965,37.28706778,120
수원한우마을 우만점,5,5,127.0363058,37.28345955,10
수원향교,5,5,127.0121047,37.27284665,10
수원화성,267,267,127.0117957,37.28695696,534
수원화성 국궁체험장,9,9,127.0236865,37.28786342,18
수원화성 남포루,4,4,127.0131924,37.27722919,8
수원화성 동북공심돈,9,9,127.0244628,37.28933376,18
수원화성 봉돈,4,4,127.0211879,37.28141786,8
수원화성 북동포루,4,4,127.0164513,37.28863954,8
수원화성 서남각루,3,3,127.0123126,37.27540918,6
수원화성 서남암문,8,8,127.0118393,37.27709598,16
수원화성 서북각루,4,4,127.0083672,37.28434063,8
수원화성 서장대,45,46,127.0102612,37.28075435,91
수원화성 연무대 관광안내소,44,45,127.0236865,37.28783099,89
수원화성 장안문 안내소,10,10,127.0140402,37.28855516,20
수원화성 팔달문,41,43,127.016733,37.27756213,84
수원화성 화서문,29,30,127.0096868,37.28557315,59
수원화성 화서문 안내소,8,7,127.0102506,37.28525774,15
수원화성 화홍문,134,140,127.0176261,37.28754551,274
수원화성 화홍문 안내소,3,3,127.0171557,37.28710858,6
수원화성박물관,84,93,127.0183249,37.19747086,177
수원화성박물관 주차장,4,4,127.0190571,37.28303649,8
수유리우동집 남대문점,2,2,126.372737,37.446292,4
수의원 분당점,5,5,127.1217033,37.38604799,10
수정사우나,3,3,127.6444792,37.30837282,6
수정식당,2,3,126.9887597,37.56974482,5
수제찹쌀씨앗호떡,5,5,127.4492433,37.27734881,10
수종사,9,9,127.3022853,37.57105042,18
수지생태공원,3,3,127.0846591,37.32352373,6
수지앤파스타,4,4,126.9212883,37.54867724,8
수진가든,3,5,127.1331636,37.66432261,8
수진사,5,5,127.2507832,37.67156605,10
수진역 8호선,5,5,127.1405345,37.43737798,10
수풀로 양수리,5,5,127.3194232,37.54822097,10
수피,4,5,127.0558883,37.54168047,9
수피레스토랑,5,4,127.2346465,37.7697066,9
수피아,4,4,126.7408227,37.57286121,8
수협강서수산물도매시장,5,5,126.8188655,37.55288933,10
수호천사펜션,2,3,127.3712147,37.69166096,5
숙대입구역 4호선,5,5,126.9721181,37.54459523,10
숙명여자대학교,3,3,126.9647258,37.5464385,6
숙성도 송도점,5,5,126.6543418,37.41239629,10
숙성시대 롯데월드몰점,5,5,127.1043552,37.51345886,10
숙소,15,7,126.4714987,33.28386228,22
숙소인근산책로,5,5,126.6500894,37.18391439,10
숙이네닭발,5,5,126.9981717,37.53290172,10
순남시래기 삼청동점,4,4,126.9822473,37.58532942,8
순대만드는집,5,5,126.9828601,37.48049083,10
순대신록,4,5,126.9640447,37.5288539,9
순덕이네한정식,8,8,127.3218468,37.33815628,16
순두부젤라또 1호점,2,2,128.9154627,37.79172826,4
순두부젤라또 2호점,2,2,128.9471035,37.77136949,4
순라길,5,5,126.9915277,37.57651873,10
순수 선릉점,4,3,127.047319,37.50536841,7
순수 청담본점,4,5,127.0430919,37.5240983,9
순수카츠,5,5,126.8973359,37.52414083,10
순우리 한우,5,5,129.3388823,35.53870164,10
순천역,38,37,127.5032361,34.94576783,75
순천종합버스터미널,4,4,127.491363,34.94759395,8
순천향대학교서울병원,5,5,127.004288,37.53376842,10
순포해수욕장,5,5,128.8869842,37.8222615,10
순희네빈대떡,13,13,127.0007245,37.5706013,26
술술상점,4,5,126.9919868,37.56056394,9
술탄터키케밥하우스,4,4,126.9942434,37.53402424,8
숨두부촌,10,10,126.9172579,37.3790676,20
숭례문,46,48,126.9753131,37.56000301,94
숭례문광장,5,5,126.9752498,37.55989848,10
숭실대입구역 7호선,8,8,126.953622,37.49631728,16
숯고개부대찌개 송탄본점,10,10,127.0538975,37.08124901,20
숲속 놀이터,4,4,127.1491855,35.81834436,8
숲속의궁전무인텔,4,4,126.6878626,37.78520467,8
숲속의쉼터글램핑,9,9,127.0288052,37.9689918,18
숲속의쉼터글램핑 공연장,4,4,127.1618034,35.84985312,8
숲속의제빵소,8,8,127.2237126,37.92061676,16
숲에그릴,4,4,127.1942431,37.07020286,8
쉐라톤그랜드 인천호텔,28,29,126.6453203,37.39033705,57
쉐라톤그랜드 인천호텔 22층 클럽라운지,10,10,126.6455026,37.3902477,20
쉐라톤그랜드 인천호텔 6층 수영장,15,15,126.6455026,37.3902477,30
쉐라톤그랜드인천호텔 피스트,10,10,126.6452702,37.39036299,20
쉐이크쉑 AK플라자분당점,3,4,127.1229098,37.38500155,7
쉐이크쉑 강남점,5,5,127.0256271,37.50286131,10
쉐이크쉑 동탄점,1,2,127.0979215,37.20067263,3
쉐이크쉑 센트럴시티점,7,7,127.0041167,37.50475613,14
쉐이크쉑 아이파크몰용산점,7,7,126.9645441,37.52884822,14
쉐이크쉑 종각점,10,9,126.9815298,37.57043498,19
쉐이크쉑 타임스퀘어영등포점,4,4,126.9043831,37.51742166,8
쉐이크포테이토,4,5,127.0405034,37.2128163,9
쉘터서울,4,3,126.9855046,37.54465169,7
쉬자파크,20,19,127.533183,37.51132307,39
쉬자파크 치유의집,10,10,127.5308669,37.5129607,20
쉴낙원 서울장례식장,5,5,126.8745912,37.48468368,10
쉼표,5,5,126.8314054,37.31076178,10
슈가스컬 센트럴시티점,4,5,127.0041845,37.50316134,9
슈가코인노래연습장 공덕점,2,1,126.9555396,37.55019076,3
슈가파머스,5,5,126.7820753,37.71001289,10
슈가판타지,4,4,126.9541399,37.39260711,8
슈가펜션,2,2,127.5115344,37.9003575,4
슈슈베어,4,5,127.0519549,37.54785592,9
슈앤디,3,4,126.9712712,37.53126653,7
슈엔,4,4,127.1047246,36.80056483,8
슈팅몬스터 서바이벌 파크,3,3,127.1262966,36.46324084,6
슈퍼 내추럴,5,5,127.0526529,37.57807773,10
슈퍼두퍼 강남점,4,5,127.0244556,37.50346703,9
슈퍼스타코인(강남논현),4,4,126.492769,33.50707896,8
슈퍼스타코인노래방 강남역2호점,5,5,127.0250881,37.50098733,10
슈퍼윙스키즈카페 수원영통점,5,5,127.0716847,37.2527179,10
스담,5,5,127.0139098,37.55974618,10
스마일맥주,5,5,127.025061,37.50112249,10
스마일스퀘어 청라점,5,5,126.6461931,37.53255375,10
스멜츠,11,12,127.1158618,37.32738149,23
스모어마켓 토이하우스2,14,15,126.9823822,37.57900965,29
스모크타운,10,10,127.0468223,36.96581301,20
스몰디쉬빅쇼,4,4,127.0211766,37.52190221,8
스몰베트남,5,5,126.9053685,37.55490226,10
스몹 하남점,5,5,127.2237408,37.54543532,10
스무디킹 스타필드코엑스몰점,5,5,127.0592756,37.50959234,10
스미레,5,5,127.0687292,37.54200887,10
스미레통,5,5,127.0448305,37.47272227,10
스미비부타동,5,5,126.9288904,37.49877915,10
스미스평화관,4,4,127.0490157,37.18461015,8
스바루,1,2,126.9861276,37.49238276,3
스시가미,4,4,127.0156415,37.27763616,8
스시나베,2,3,126.902563,37.52010516,5
스시노칸도 수유점,4,5,127.0252863,37.63905852,9
스시노칸도 홍대점,2,3,126.9208387,37.55221246,5
스시누하,2,3,126.9686558,37.57912055,5
스시다이와 의왕백운호수점,3,3,127.0098393,37.37445185,6
스시다정,3,4,126.9306788,37.52149453,7
스시롭다,1,1,127.0237176,37.50852002,2
스시류 일원점,5,5,127.0815966,37.49078134,10
스시린,5,4,127.1113273,37.25375771,9
스시마시따,5,5,127.0002627,37.58342065,10
스시마이우 고속터미널본점,5,5,127.0012848,37.50531121,10
스시마카세 여의도점,10,10,126.9292167,37.51974302,20
스시미소,3,4,126.9164371,37.52826986,7
스시미우,4,4,126.9729292,37.39163259,8
스시바 신세계백화점본점,1,1,126.980981,37.56092488,2
스시박사,3,3,127.0622792,37.65579318,6
스시사쿠 구월점,5,5,126.7086404,37.44214269,10
스시산원 궁,3,3,126.9790123,37.574726,6
스시소라 서초점,4,4,127.0096342,37.49200837,8
스시쇼부 쇼부2호,4,4,126.9250609,37.60204289,8
스시신조,4,4,127.0221081,37.56596091,8
스시아지 갤러리아 광교점,1,1,127.0572543,37.28522902,2
스시애,10,10,127.083642,37.5109255,20
스시오야붕,4,4,126.7412919,37.35159594,8
스시오하요,5,5,127.0956656,37.50418046,10
스시원,4,4,126.7378732,37.53588326,8
스시윤 대화본점,5,5,126.7535439,37.67925871,10
스시지현,4,4,126.9236117,37.56065302,8
스시초이스,3,4,126.7576706,37.49054928,7
스시카제,5,5,126.643318,37.38387429,10
스시코하루,5,5,126.9289305,37.51967437,10
스시쿤 판교,10,10,127.107253,37.40019451,20
스시텐 강변점,9,9,127.093962,37.53821089,18
스시한판 수원점,3,3,127.0015107,37.26727161,6
스시환,5,5,127.0162863,37.48545911,10
스아게K,5,5,126.9273971,37.55542422,10
스와치 스타필드 코엑스몰점,4,4,127.0588266,37.51252893,8
스웨이커피스테이션,4,4,126.928586,37.56903089,8
스위스모텔,5,4,127.0040799,37.5755495,9
스위티안,5,5,127.4881997,37.69465025,10
스위티안호텔 레스토랑,5,5,127.4881138,37.69451816,10
스윗카고 & 카고닭강정,8,9,127.5172037,37.8184344,17
스윙카페,10,10,127.5267749,37.79436726,20
스즈란테이 이촌점,4,4,126.9743037,37.51996956,8
스카이래빗,4,5,126.9223683,37.55480474,9
스카이썬호텔,5,5,127.4487314,37.2758217,10
스카이호텔,5,5,127.1084847,37.27125137,10
스카이호프,5,5,126.5283034,33.51278396,10
스케줄 청담,5,5,127.0427031,37.52459669,10
스코브,2,3,127.0401494,37.54697033,5
스코프 부암점,13,15,126.9635987,37.59312414,28
스쿠퍼젤라또,10,10,126.9711863,37.57838238,20
스퀘어원,9,9,126.6837147,37.40580559,18
스크린골프 카카오 은계,5,5,126.8039984,37.4365458,10
스타버스코인노래연습장 신림점,4,4,126.9299906,37.48318337,8
스타벅스,7,8,129.1208587,35.1550479,15
스타벅스 강남2점,4,3,127.025564,37.50018416,7
스타벅스 강남R점,5,5,127.0284434,37.49767447,10
스타벅스 강서구청사거리점,4,4,126.8522105,37.55480985,8
스타벅스 경기광주송정DT점 주차장,3,4,127.2725764,37.41628334,7
스타벅스 경기광주신현DT점,3,3,127.1531362,37.35988986,6
스타벅스 경기양평점,4,4,127.49997,37.49104453,8
스타벅스 경복궁사거리점,11,11,126.9802629,37.57558486,22
스타벅스 경복궁역점,8,8,126.9726765,37.57720424,16
스타벅스 경주중앙점,5,5,129.2124446,35.84210536,10
스타벅스 곤지암IC DT점,5,5,127.32524,37.35564852,10
스타벅스 과천DT점,4,4,126.9938461,37.43923276,8
스타벅스 관악서울대입구R점,4,4,126.9528094,37.47930953,8
스타벅스 광교엘포트R점,8,8,127.0578453,37.28683709,16
스타벅스 광교역점,4,4,127.044092,37.3005523,8
스타벅스 광나루,5,5,127.1060468,37.54742239,10
스타벅스 광명역점,4,4,126.8819966,37.41661256,8
스타벅스 광장점,5,5,127.0995935,37.54257793,10
스타벅스 광주송정로점,5,5,126.7916599,35.13719306,10
스타벅스 광화문D타워점,5,4,126.9790633,37.5704661,9
스타벅스 광화문우체국점,3,3,126.9780582,37.56997217,6
스타벅스 광화문점,17,18,126.9762965,37.57122962,35
스타벅스 구리돌다리점,4,4,127.1418283,37.60053357,8
스타벅스 국립중앙의료원점,3,3,127.0063432,37.56645295,6
스타벅스 기흥테라타워점,4,4,127.0710036,37.23074182,8
스타벅스 김포시청점,3,4,126.7179533,37.61839161,7
스타벅스 김포장기커낼점,4,4,126.6776404,37.63955246,8
스타벅스 김포현대아울렛3층점,4,4,126.7852355,37.59723749,8
스타벅스 남가좌사거리점,5,5,126.9201873,37.5772552,10
스타벅스 남부터미널2점,5,5,127.014174,37.48434574,10
스타벅스 남양주삼패점,4,4,127.1995855,37.59185459,8
스타벅스 남영동,3,3,126.9722908,37.54287616,6
스타벅스 남위례역점,3,4,127.1411358,37.46452028,7
스타벅스 남이섬점,27,27,127.5253457,37.80657161,54
스타벅스 남한산성입구역점,4,4,127.1594591,37.44968974,8
스타벅스 노량진역점,4,4,126.9408752,37.51339105,8
스타벅스 당진시곡DT점,5,5,126.6836545,36.90276888,10
스타벅스 대구계산,5,5,128.5897007,35.86643882,10
스타벅스 대학로점,4,5,127.0011819,37.57663796,9
스타벅스 더북한강R점,5,5,127.3420084,37.61240639,10
스타벅스 더양평DTR,30,30,127.481696,37.4970256,60
스타벅스 더종로R점,17,17,126.9833989,37.57083629,34
스타벅스 동국대점,3,4,126.9985716,37.5614706,7
스타벅스 동대문디자인플라자점,5,5,127.0101419,37.56715006,10
스타벅스 동성로중앙점,5,5,128.5966656,35.86749449,10
스타벅스 동탄능동DT점,4,4,127.0535015,37.21206886,8
스타벅스 동탄라크몽점,8,8,127.1050077,37.16723836,16
스타벅스 레스케이프호텔R점,8,8,126.979494,37.55983442,16
스타벅스 루원시티점,5,5,126.6699899,37.52294413,10
스타벅스 리버사이드팔당DTR,9,9,127.2283627,37.56710983,18
스타벅스 마곡역,3,3,126.8259972,37.55934398,6
스타벅스 마곡웰튼,9,8,126.8253052,37.56728253,17
스타벅스 마로니에공원점,6,6,127.0023639,37.58148169,12
스타벅스 명동길점,10,11,126.9859064,37.56210587,21
스타벅스 명동역점,13,13,126.9831043,37.56086213,26
스타벅스 몽촌토성,5,4,127.4806295,35.18012007,9
스타벅스 무교로점,3,3,126.9789238,37.56728016,6
스타벅스 문래역점,5,5,126.895111,37.51746334,10
스타벅스 미사역그랑파사쥬점,3,3,127.1915343,37.56422006,6
스타벅스 미사역효성,4,4,127.1900471,37.56691013,8
스타벅스 발산역,4,3,126.8390984,37.56006174,7
스타벅스 별다방점,5,5,126.9827298,37.56004397,10
스타벅스 보라매공원R점,8,8,126.9235097,37.49208851,16
스타벅스 부천심곡DT점,5,5,126.7844128,37.49293291,10
스타벅스 부평역점,5,5,126.7221514,37.49149372,10
스타벅스 북촌로점,20,20,126.9864647,37.5794519,40
스타벅스 분당궁내DT점,10,10,127.1021463,37.37060402,20
스타벅스 분당서현역 AK R점,5,5,127.1232027,37.38457777,10
스타벅스 분당율동공원점,2,2,127.1499919,37.38395395,4
스타벅스 불광역점,10,10,126.9303028,37.60943512,20
스타벅스 삼청동점,4,4,126.9817582,37.58535097,8
스타벅스 상암DMC점,3,3,126.8909274,37.57766517,6
스타벅스 새문안로점,3,3,126.9748968,37.56964538,6
스타벅스 서동탄DT점(오산외삼미로),5,5,127.0649576,37.19741186,10
스타벅스 서울역사점,15,15,126.9717026,37.55414662,30
스타벅스 서울역서부점,2,3,126.9684645,37.55493958,5
스타벅스 서울웨이브아트센터점,12,12,127.0069601,37.51875129,24
스타벅스 서울중앙우체국점,3,3,126.9820538,37.56132238,6
스타벅스 서울타워점,4,4,126.9882985,37.55153203,8
스타벅스 석촌서호점,4,4,127.0965371,37.50646831,8
스타벅스 석촌역점,5,5,127.1061973,37.50435166,10
스타벅스 석촌호수점,3,3,127.1053405,37.5095242,6
스타벅스 선릉역점,5,5,127.0485903,37.50389566,10
스타벅스 선유도역1번출구점,3,3,126.8936641,37.5382905,6
스타벅스 성남모란DT점,3,3,127.1334386,37.42921219,6
스타벅스 성수낙낙,5,5,127.0663258,37.54718919,10
스타벅스 센트럴시티점,5,5,127.0045046,37.50477413,10
스타벅스 송도센트럴파크점,3,3,126.641521,37.39465315,6
스타벅스 송도캐슬파크점,2,2,126.6411772,37.3845643,4
스타벅스 송파KT점,11,11,127.1063026,37.51399952,22
스타벅스 송파나루역DT점,4,4,127.1103066,37.51085675,8
스타벅스 송파방이DT점,4,3,127.1204962,37.50656523,7
스타벅스 수서역사거리점,5,5,127.1031067,37.48731817,10
스타벅스 수원경수인계DT점,4,4,127.0275505,37.27044369,8
스타벅스 수원광교점,4,5,127.049745,37.29023949,9
스타벅스 수원매산점,4,4,127.0026607,37.26732746,8
스타벅스 수원세류DT점,4,4,127.0112509,37.26279111,8
스타벅스 숙대입구역점,9,9,126.9719463,37.54424921,18
스타벅스 숭례문SG타워점,4,4,126.974413,37.55783682,8
스타벅스 숭례문북창점,3,2,126.976707,37.5617296,5
스타벅스 스타필드고양1F R점,4,3,126.8959393,37.64710366,7
스타벅스 스타필드부천점,4,4,126.8134548,37.46111547,8
스타벅스 스타필드하남2FR점,3,3,127.2244188,37.54512499,6
스타벅스 시흥목감DT점,5,5,126.8500528,37.37794328,10
스타벅스 신당역사거리점,5,5,127.0164305,37.56580686,10
스타벅스 신사가로수점,5,5,127.0225567,37.52188664,10
스타벅스 신설동역점,9,10,127.0255663,37.57662439,19
스타벅스 안국점,20,20,126.985736,37.57743359,40
스타벅스 안암역점,5,5,127.0307686,37.58610881,10
스타벅스 안양범계,4,4,126.9537633,37.39172035,8
스타벅스 안양역,5,5,126.9221755,37.40033557,10
스타벅스 양주고읍DT점,9,9,127.0793606,37.80349528,18
스타벅스 양주광사DT점,3,3,127.0728598,37.7907526,6
스타벅스 양주송추DT점,5,5,126.9731309,37.71759199,10
스타벅스 여의도신한금융투자타워점,4,4,126.9241822,37.52489633,8
스타벅스 여의도화재보험점,4,4,126.9258691,37.52127537,8
스타벅스 여주DT점 주차장,4,4,127.6382474,37.26622157,8
스타벅스 여주프리미엄입구점,4,5,127.6125205,37.24099168,9
스타벅스 연신내점,4,4,126.9199567,37.62023681,8
스타벅스 연희동점,3,3,126.9305192,37.56671739,6
스타벅스 영동2교점,5,5,127.0426245,37.48197465,10
스타벅스 영등포시장교차로점,5,5,126.9044584,37.5204599,10
스타벅스 오산원동DT점,4,4,127.0738761,37.14418124,8
스타벅스 올림픽공원남문점,5,5,127.1230747,37.51335974,10
스타벅스 용인마북DT,4,4,127.1103589,37.29465863,8
스타벅스 용인보라DT점,8,8,127.1043726,37.25558415,16
스타벅스 용인에버랜드R점,14,14,127.2031879,37.29497808,28
스타벅스 원주반곡DT점,5,5,127.9717,37.31976596,10
스타벅스 원흥역,4,4,126.876666,37.6493779,8
스타벅스 웨스턴돔B점,3,3,126.7732991,37.65437726,6
스타벅스 을지로삼화타워점,3,3,126.9846876,37.56692065,6
스타벅스 을지로한국빌딩점,4,5,126.9834518,37.56566269,9
스타벅스 의왕청계DT점,8,7,126.9983784,37.38841001,15
스타벅스 의정부공원점,4,3,127.0476098,37.74008809,7
스타벅스 의정부민락,4,4,127.0940033,37.7454264,8
스타벅스 의정부장암 DT점,6,7,127.0546502,37.69920342,13
스타벅스 이천사음DT점,5,5,127.4080109,37.29901836,10
스타벅스 이천터미널점,4,4,127.446332,37.27830951,8
스타벅스 이촌점,5,5,126.9772679,37.5186475,10
스타벅스 인천구월점,5,5,126.7011548,37.44647589,10
스타벅스 인천논현점,4,4,126.7250043,37.39947557,8
스타벅스 일산가로수길R점,5,5,126.7571826,37.66575069,10
스타벅스 장한평역점,3,3,126.8008719,33.48825545,6
스타벅스 적선점,3,3,126.9741172,37.57531247,6
스타벅스 정동점,2,3,126.9700593,37.56854774,5
스타벅스 제주서해안로DT점 주차장,4,4,126.5035626,33.51668313,8
스타벅스 종로3가점,5,5,126.9902153,37.57057927,10
스타벅스 주얼리시티점,6,6,126.9981345,37.57157797,12
스타벅스 중동디지털프라자,4,4,126.7706085,37.50317476,8
스타벅스 청담영동대로점,5,5,127.0564574,37.52209244,10
스타벅스 코엑스별마당점,5,5,127.0591597,37.51182328,10
스타벅스 타임스퀘어2F점,5,5,126.9033058,37.51693063,10
스타벅스 태평로점,8,8,126.9767113,37.56250086,16
스타벅스 파주P아울렛1F점,5,4,126.6963864,37.76953491,9
스타벅스 파주야당DT점,4,4,126.759687,37.70348598,8
스타벅스 판교알파돔타워,14,14,127.1103648,37.39426202,28
스타벅스 평내호평역,3,3,127.2430092,37.65402405,6
스타벅스 평촌역사거리점,4,3,126.9649365,37.39595179,7
스타벅스 평택서정DT점 주차장,5,5,127.063541,37.06597649,10
스타벅스 평택안중DT점,5,4,126.913379,36.99087687,9
스타벅스 포스코점,5,5,127.0580511,37.50576187,10
스타벅스 포천DT점,5,5,127.1618261,37.84841538,10
스타벅스 하남신장점,3,3,127.2039868,37.53838204,6
스타벅스 현대신촌점,2,1,126.9358437,37.55608144,3
스타벅스 화정역,3,3,126.8328951,37.63341175,6
스타벅스 환구단점,5,5,126.9791283,37.56447539,10
스타벅스 황학캐슬점,5,5,127.0227968,37.57125863,10
스타벅스대화역점,4,4,126.9187285,33.44181526,8
스타스테이,4,4,127.3788541,37.59035576,8
스타오리,4,4,127.0799288,37.75752326,8
스타이발관,3,2,126.9881413,37.57223692,5
스타즈호텔 독산,4,4,126.8971178,37.46129901,8
스타즈호텔 명동2호점,7,7,126.9906419,37.56255324,14
스타피카소복합빌딩,4,4,126.9249869,37.55722111,8
스타필드 고양,111,107,126.8949597,37.64697647,218
스타필드 고양 주차장,5,5,126.8943019,37.64738673,10
스타필드 안성,58,57,127.0951304,36.71102355,115
스타필드 안성 찜질스파,4,4,127.1473624,36.9947384,8
스타필드 코엑스몰,95,93,127.0597769,37.51131841,188
스타필드 하남,161,165,127.2236912,37.54549307,326
스타필드시티 부천,32,33,126.8139049,37.4614874,65
스타필드시티 위례,9,9,127.148402,37.48011055,18
스타필드시티위례,3,4,127.1484021,37.48013398,7
스타힐스호텔,4,4,126.9776804,37.56148111,8
스탠포드호텔 명동,13,13,126.9826971,37.56464896,26
스탠포드호텔 서울,21,21,126.8866953,37.58236797,42
스테이25호텔,3,4,127.0748909,37.25318446,7
스테이83,10,9,127.5169675,37.82038869,19
스테이션,5,5,127.4255567,37.73595181,10
스테이여백,5,5,126.4088896,37.59893669,10
스테이온디엣지 풀램핑,15,15,127.3726798,37.68944715,30
스테이지28 웁시데이지,4,4,127.146795,37.56474007,8
스테이카키,10,10,126.9999593,37.5340388,20
스템커피 코엑스점,4,3,127.0594265,37.51166097,7
스토리PC랩 범계역점,4,4,126.9528106,37.39109647,8
스토리웨이 서울역1호점,3,3,126.9707552,37.55457166,6
스톡드,2,3,126.9622822,37.5250606,5
스톤밸리바베큐,3,3,127.2294915,37.53178677,6
스튜디오4BPM,5,5,126.9686556,37.54432406,10
스틸301,5,5,128.7111311,36.1458654,10
스파레이,5,5,127.0182073,37.51807164,10
스파렉스 불가마사우나,5,5,127.0583135,37.23738946,10
스파렉스24시 불가마사우나,5,5,127.0712061,37.25196852,10
스파오 구리점,5,5,127.1420707,37.60178385,10
스파오 라붐서울대점,2,3,126.9521752,37.48099597,5
스파오 롯데마트청량리점,5,3,127.0486128,37.58029501,8
스파오 성신여대점,3,3,127.0172788,37.5926023,6
스파오 코엑스몰점,3,5,127.0571156,37.51294514,8
스파오 타임스퀘어점,5,5,126.9037115,37.51723731,10
스파편의점,1,1,127.0579976,37.66146614,2
스페로스페라카페,5,4,127.0186438,37.28958711,9
스페이스 헬레나,4,4,126.9389514,37.64210608,8
스페이스K서울미술관,3,3,126.8309742,37.56110996,6
스페이스길,4,4,126.9739186,36.98521075,8
스페이스작,13,13,126.8085401,37.50857447,26
스페인목장 송도점,5,5,126.6473628,37.39443464,10
스펙트럼갤러리,2,2,126.9923149,37.53971846,4
스포애니 수내점,5,5,127.1236868,37.36996085,10
스포츠몬스터,3,4,126.243402,33.39697005,7
스포츠몬스터 안성점,2,3,127.1465685,36.99478275,5
스포츠아일랜드,4,5,127.0352216,37.28966984,9
스핀볼링센터 가든5점,2,2,127.1226657,37.47770195,4
슬럼덩크 수제버거,5,5,126.9525311,37.3901629,10
슬로우 보틀,4,4,126.937183,37.47053003,8
슬로우스테디클럽 디스커버리 서울숲점,5,5,127.0423543,37.54789579,10
슬로우써니사이드,4,4,127.0135207,37.2847258,8
슬로우치즈,4,4,127.0469915,37.52237409,8
승남집,5,5,126.9075389,37.51755932,10
승일공원,3,4,127.3020615,38.18624146,7
시간의조각 계절,1,2,126.9261087,37.55817687,3
시고르,9,9,127.4879608,37.83168778,18
시골국수 수제돈까스,4,4,127.3450377,37.8314283,8
시골맛집,5,5,127.2172119,37.28658885,10
시골밥상,3,3,127.3772942,37.68049483,6
시골빈대떡파전 선릉본점,5,5,127.047103,37.50542797,10
시골집,4,3,126.9953865,37.56483845,7
시골향기 운양점,4,4,126.700916,37.64682071,8
시그니엘 서울,50,51,127.1028698,37.51244923,101
시그니엘서울 더라운지,5,5,127.1025443,37.51263692,10
시그니엘서울 살롱드시그니엘,5,5,127.1024941,37.51228017,10
시그니엘서울 스테이,5,5,127.1024896,37.51229459,10
시그니처랩 반포점,1,2,127.0061298,37.50447673,3
시나모롤카페,5,5,126.9260258,37.5580307,10
시나본 남산서울타워점,5,5,126.9878685,37.55112113,10
시래마루,5,5,127.3354191,37.35090954,10
시러피하우스,5,4,126.9254211,37.54860424,9
시루향기 동탄점,5,5,127.0732483,37.20505875,10
시마스시,4,4,127.0595737,37.51185911,8
시마스시 용산아이파크몰점,4,4,126.9643517,37.52886347,8
시몬스 그로서리스토어청담,6,6,127.0412124,37.52512971,12
시몬스 테라스점,17,22,127.4462622,37.19765239,39
시몬스테라스점(이코복스커피),2,5,127.4462547,37.197657,7
시민공원,1,1,127.0528871,37.74572951,2
시바스버거 2호점,5,5,126.8824404,37.41884753,10
시방은새우시대 본점,2,2,126.7251006,37.49082036,4
시오,5,5,126.9142783,37.54727401,10
시오스,3,3,127.2096353,37.53681702,6
시장정육점식당,4,4,127.1222531,36.46586203,8
시저커피,1,1,126.8390905,37.29979788,2
시청역 1호선,14,14,126.9771982,37.5653454,28
시청역 2호선,3,3,126.9755983,37.56368184,6
시카노이에,5,3,126.9692415,37.5725903,8
시크릿가든펜션,5,5,127.1768782,37.92578858,10
시크릿문펜션,3,3,127.4669437,37.81543337,6
시타마치텐동아키미츠 종로타워점,5,5,126.9836092,37.5707173,10
시티백,9,9,126.9917406,37.53489446,18
시티파크PC방,3,3,126.9716,37.29893073,6
시화나래조력공원,14,14,126.6071697,37.31192382,28
시화나래휴게소,29,30,126.6064297,37.31118561,59
시화방조제,6,6,126.6063307,37.30927201,12
시화호,3,3,126.6969276,37.28947449,6
시후쿠 신용산점,5,5,126.9631384,37.5254411,10
시흥갯골생태공원,75,81,126.8609818,37.33558272,156
시흥꿈상회 오이도점,4,5,126.6874868,37.345467,9
시흥대야역 서해선,5,5,126.7929938,37.45009987,10
시흥목감한신더휴센트럴파크아파트,8,8,126.8495905,37.37541442,16
시흥배곧한울공원,24,24,126.7020249,37.35465713,48
시흥시청역 서해선,3,3,126.8059481,37.38156162,6
시흥신세계아울렛,4,4,127.0069895,37.50607506,8
시흥오이도박물관,25,28,126.6909132,37.33553858,53
시흥프리미엄아울렛,70,69,126.7370807,37.3797815,139
시흥하늘주유소 일산방향,5,5,126.8562297,37.38513661,10
시흥하늘휴게소 양방향,6,7,126.8554958,37.38393195,13
시흥하늘휴게소 판교방향,14,13,126.8546584,37.38371108,27
식객,2,2,126.7694179,37.88131158,4
식껍 남대문 본점,5,5,126.9720331,37.56026357,10
식물감각,3,2,126.6987423,37.78752503,5
식물학,5,5,127.0216552,37.51837019,10
식스티즈,5,5,126.9243513,37.55346534,10
식자재왕도매마트 부개점,5,5,126.7399466,37.49137836,10
식자재왕도매마트 시화점,3,3,126.7320109,37.3449275,6
식품명인체험홍보관,10,10,126.9858377,37.57840307,20
신가원설렁탕 무교본점,4,5,126.9799563,37.56653791,9
신간짬뽕,7,8,127.51289,37.82726182,15
신간짬뽕 금촌점,4,5,126.7777644,37.75754355,9
신갈리돈가스,3,3,127.4458127,37.19781987,6
신건영빌리지2차 9동,3,4,127.0402479,37.65426027,7
신고집찜칼국수 본점,4,4,127.0701105,37.63948098,8
신구대학교식물원,3,3,127.0808677,37.43452178,6
신기소 정동점,3,3,126.9693475,37.56799165,6
신기시장,5,5,126.6775999,37.44739788,10
신기종합어시장포장회전문점,3,4,126.6800126,37.44927404,7
신길역 1호선,7,6,126.9183672,37.51678703,13
신길역 5호선,3,3,126.9149139,37.51766397,6
신길역사유적공원,3,4,126.7856618,37.33573645,7
신내강호해장국,4,4,127.5281873,37.46558474,8
신내서울해장국집 본점,9,9,127.527858,37.46505011,18
신내역 6호선,5,5,127.1042714,37.61249102,10
신논현역 9호선,17,18,127.0254696,37.50479369,35
신논현역 신분당선,3,3,127.0249262,37.5036165,6
신논현역 신분당선 7번출구,4,4,127.0247677,37.50331199,8
신당동떡볶이타운,5,5,127.0146099,37.56303203,10
신당역 2호선,4,4,127.0194775,37.56567305,8
신당역 6호선,4,4,127.0161759,37.56609251,8
신당역 6호선(전철역),5,5,127.0161118,37.567534,10
신대호수,14,14,127.073864,37.28664256,28
신덕고개,4,4,127.2805845,37.19925451,8
신도림역 1호선,21,19,126.8913125,37.50890848,40
신도림테크노마트,12,13,126.8902656,37.50704784,25
신돈,4,5,127.0814757,37.50963317,9
신동궁 감자탕뼈숯불구이,5,5,126.9839634,37.5656988,10
신동해해물탕 평택점,3,3,127.1116343,36.99349796,6
신라면세점 서울점,14,14,127.0077299,37.55715368,28
신라방마라탕,5,5,127.0645397,37.5650083,10
신라숯불흑돼지식당,4,5,127.0977888,37.84736518,9
신라스테이 광화문,37,37,126.9811486,37.57255448,74
신라스테이 구로,6,6,126.9042326,37.48560613,12
신라스테이 동탄,23,24,127.0731962,37.20248899,47
신라스테이 마포,5,5,126.9496826,37.54277679,10
신라스테이 삼성,33,34,127.0631637,37.50992351,67
신라스테이 서대문,5,6,126.9668042,37.56518706,11
신라스테이 서초,26,26,127.0301272,37.48944605,52
신라스테이 천안,5,5,127.1431876,36.82574501,10
신라쌈밥식당,2,2,129.215423,35.8346972,4
신라아이파크면세점,2,2,126.9630777,37.52926493,4
신륵사관광지,13,14,127.6599364,37.29742583,27
신림교,5,5,126.9288749,37.48178073,10
신림역 2호선,6,7,126.9297454,37.48426714,13
신림역 신림선,4,4,126.9296295,37.48488155,8
신매대교 인증센터,4,5,127.7130289,37.92029823,9
신미경홍대닭갈비,2,2,126.9218347,37.55208698,4
신반포역 9호선,4,4,126.9960824,37.50350914,8
신복환승센터,4,4,129.2629869,35.55091647,8
신봉2어린이공원,5,5,127.0723148,37.3291075,10
신북리조트 스프링폴,4,4,127.1044784,37.97427165,8
신북리조트스프링폴 야외워터파크,4,4,127.1051037,37.97381882,8
신사890,4,4,127.0215543,37.51754038,8
신사개나리공원,5,4,127.0294111,37.52566033,9
신사동 가로수길,5,4,126.4083776,33.48645688,9
신사동가로수길,7,7,127.022837,37.52115587,14
신사역 3호선,29,29,127.0203086,37.51643598,58
신사역 신분당선,4,3,127.0195517,37.51608201,7
신사우물갈비 평택점,2,3,127.1132264,36.99900837,5
신사하우스,9,9,127.0206332,37.52040484,18
신성루,3,4,126.6264262,37.46978321,7
신세계면세점 명동점,6,6,126.9806506,37.56052658,12
신세계백화점 강남점,91,95,127.0043203,37.50530573,186
신세계백화점 경기점,9,9,127.1082562,37.32502995,18
신세계백화점 대구점,5,5,128.6289649,35.87779693,10
신세계백화점 본점,55,55,126.9810896,37.56094832,110
신세계백화점 본점 신관,6,6,126.9807932,37.56026712,12
신세계백화점 스타필드하남점,8,8,127.2223166,37.5459714,16
신세계백화점 의정부점,6,5,127.0463089,37.73721362,11
신세계백화점 타임스퀘어점,25,26,126.9056107,37.51718208,51
신세계센트럴시티,20,19,127.0041314,37.50468314,39
신세계약국,2,3,126.9914017,37.57012887,5
신세계프리미엄아울렛 여주,89,87,127.6121957,37.24139161,176
신세계프리미엄아울렛 여주 EAST,8,8,127.6129898,37.2421705,16
신솥 해장국&돼지국밥,5,5,126.7348271,37.83784906,10
신승반점 본점,19,19,126.6178059,37.47546802,38
신신기업 전기차충전소,5,5,126.8412559,37.57163704,10
신안주유소,5,5,127.2904476,36.62518257,10
신용산 닭한마리,3,3,126.970268,37.53049412,6
신의주순대와쭈꾸미 동탄역점,1,1,127.0971114,37.19785841,2
신의주찹쌀순대 김포고촌점,5,5,126.7674069,37.6003896,10
신장쇼핑몰,5,5,127.0510451,37.08069521,10
신정역 5호선,5,5,126.8560975,37.52502761,10
신중동역 7호선,9,9,126.7768972,37.50295254,18
신중동역칙칙폭폭도서관,5,5,126.7768926,37.50297055,10
신창역 1호선,5,5,126.9513931,36.7696423,10
신천역 서해선,5,3,126.7867851,37.43924605,8
신철원시장,3,4,127.3096388,38.14481632,7
신촌이대거리,4,4,126.9391157,37.55739142,8
신촌파랑고래,5,5,126.9351188,37.5568595,10
신촌황소곱창 선릉직영점,2,3,127.0524038,37.50371743,5
신탄진역,3,3,127.4285634,36.44968413,6
신탄진휴게소 서울방향,9,9,127.4184994,36.42675467,18
신포국제시장,121,122,126.6267206,37.47148884,243
신포닭강정,9,9,126.7199228,37.45267035,18
신포닭강정 본점,32,31,126.6281751,37.47158533,63
신포문화의거리,3,4,126.6276894,37.47217666,7
신포순대 본점,2,2,126.6262682,37.47154508,4
신포시장,5,5,127.7765133,37.8914525,10
신포찬누리닭강정,4,4,126.6282376,37.47173329,8
신한은행 명동지점,5,5,126.9847414,37.56393385,10
신해철작업실,3,4,127.1268502,37.36599659,7
신호등장작구이 서오릉본점,10,10,126.8971893,37.6259089,20
신흥덕롯데캐슬레이시티아파트,4,3,127.1018625,37.27246014,7
신흥시장,4,4,126.9849907,37.54531476,8
실로암연수원펜션,5,5,127.3710905,37.68493649,10
실로커피 의정부점,5,5,127.0484109,37.73685509,10
실미도유원지,4,4,126.4029656,37.4034274,8
실학박물관,16,17,127.3006672,37.51596944,33
심곡서원,3,3,127.0766125,37.30576443,6
심스커피,5,5,127.3550391,37.34984944,10
심야의숲,3,4,127.0606625,37.54342065,7
심학산 약천사,5,5,126.7011199,37.7055955,10
심학산도토리국수 본점,15,15,126.7038896,37.70948567,30
심학산둘레길,4,4,126.7045507,37.70406348,8
십리향,9,9,126.6188253,37.47509289,18
십분의일,5,5,126.9902341,37.56531025,10
십원집 봉천점,3,3,126.9562689,37.47944422,6
싱글벙글복어 종로점,4,4,126.9897305,37.57271279,8
싱싱오징어바다 방이점,2,3,127.1090219,37.51484399,5
싱싱종합어시장,4,4,127.4467263,37.28014613,8
싱싱주스,3,3,127.0339899,37.58906679,6
싸다김밥,3,3,126.9495972,37.48128322,6
싸다김밥 동대문점,5,4,127.0075838,37.56733225,9
싸다김밥 성신여대점,4,4,127.0132965,37.59213521,8
싸리제골,5,5,127.5885641,37.58791062,10
싸움의고수 가천대점,4,4,127.1271067,37.44836033,8
싹쓰리 솥뚜껑김치삼겹살,5,5,127.2560847,37.41256838,10
쌀로쌀롱,5,5,126.8505141,37.47537439,10
쌈지길,52,51,126.9847313,37.57435206,103
쌈지길 별관,4,4,126.9848491,37.57423675,8
쌍용더플래티넘부평아파트,5,5,126.6971846,37.50564299,10
쌤쌤쌤,9,9,126.9721592,37.53157038,18
써니롤러스케이트장,4,4,126.6294886,37.47641524,8
써머레인,4,4,126.9992646,37.53635437,8
써브웨이 강변역점,5,5,127.0933825,37.53530941,10
써브웨이 동탄하이페리온점,3,3,127.0714809,37.2021816,6
써브웨이 서울숲점,5,5,127.0447666,37.54738674,10
써브웨이 선정릉역점,2,3,127.0429344,37.50975708,5
써브웨이 수원로데오점,2,3,127.0022886,37.26716528,5
써브웨이 시흥능곡역점,4,3,126.807154,37.37009897,7
써브웨이 안국점,5,5,126.982458,37.57519508,10
써브웨이 약수역점,3,3,127.0118428,37.5573867,6
써브웨이 인천송도지웰푸르지오시티점,3,3,126.6438199,37.38423171,6
써브웨이 인천송도트리플스트리트점,3,4,126.661251,37.37986675,7
썬데이스낵,3,4,127.0309663,37.61503416,7
썬스타,8,8,127.0138494,37.28761449,16
썬오브글램핑,5,4,127.3896596,38.08776695,9
쎄레알카페,4,4,126.7054975,37.7714041,8
쎄임더스트,3,3,127.1262966,36.46324084,6
쎈느,2,4,127.0534442,37.54489277,6
쎈스프래그런스,5,5,127.0206827,37.51937949,10
쎈토이박물관,4,4,127.6157554,37.24465111,8
쏘슐랭,5,5,126.9254569,37.56261297,10
쏘카스테이션 강릉,1,1,128.9020868,37.76431092,2
쏘카존 수원역(KTX) 위더뷰오피스텔,5,5,127.0013112,37.2680357,10
쏠띵즈,3,3,126.9222706,37.56602749,6
쏠하우스,8,8,128.8938864,37.81416929,16
쏭타이 이태원점,5,5,126.9926866,37.53372142,10
쓰리팝PC,3,3,126.9807954,37.48563978,6
씨사이드파크,4,4,126.5261964,37.47426041,8
씨씨할인마트,3,3,127.5162272,37.82172534,6
씨에이치빌,5,5,127.0995601,37.501267,10
씨티파크모텔,1,4,126.9898387,37.57656545,5
씰리침대 청담직영점,5,5,127.0511095,37.51629241,10
아가일커피클럽,5,5,127.2564308,37.4110377,10
아가페식당,4,4,127.0701439,38.01567685,8
아공관,3,3,126.9849409,37.545358,6
아그라 코엑스점,5,5,127.0590869,37.51124667,10
아꼬떼펜션,3,3,127.3549247,37.94317616,6
아난티코드,9,9,127.4802174,37.62549276,18
아난티코드GC,5,5,127.4823529,37.62008899,10
아날로그프로젝트,3,2,127.1378878,37.60808493,5
아네모오네,4,5,126.6252239,37.47239232,9
아늑감,4,4,127.0121742,37.28428264,8
아다마스253,4,4,126.6980193,37.78776824,8
아더 성수 스페이스,8,10,127.0565428,37.54226041,18
아더 스페이스 2.0 플래그십 스토어,9,8,127.0565428,37.54226041,17
아더 신사 스페이스,10,10,127.0221035,37.51957565,20
아도니스아트힐호텔,10,10,127.1954863,37.96590848,20
아뜨뜨,3,3,126.9255944,37.56094081,6
아뜰리에아키,3,3,127.0429051,37.54550254,6
아띠,4,4,126.9368293,37.51473685,8
아띠 캠핑장,6,6,127.016682,38.08123687,12
아띠아,5,5,126.767364,37.65922379,10
아띠오아나폴리핏제리아 송도점,4,4,126.650964,37.3959212,8
아띠커피,5,5,127.0585777,37.56591961,10
아라김포여객터미널,10,11,126.7869691,37.59765509,21
아라김포여객터미널 주차장,9,8,126.7867996,37.59832872,17
아라리오뮤지엄 인 스페이스,5,5,126.988548,37.57774384,10
아라마루전망대,9,9,126.7013572,37.57278239,18
아라마리나클럽하우스,3,3,126.7890454,37.59943376,6
아라타워,15,15,126.6075269,37.55846309,30
아람착한코다리 권선점,5,5,127.0368585,37.25144357,10
아로이커피 녹번점,5,5,126.9330687,37.60664005,10
아르디움카페,4,5,126.6918063,37.71683545,9
아르떼,4,4,127.0027052,37.37641916,8
아르떼 채플&컨벤션,4,5,126.9649048,37.39625813,9
아르무아,4,4,127.0709241,37.5417661,8
아르켓 가로수길점,5,5,127.0232087,37.51985565,10
아르켓 더현대서울점,5,5,126.928428,37.52593513,10
아르코미술관,12,12,127.0032378,37.58046174,24
아르피아타워,2,2,127.104601,37.32607393,4
아름다운청년전태일기념관,2,2,126.9893825,37.56842042,4
아름다운펜션,6,6,127.3197588,38.08046752,12
아름드리장어,5,5,126.830122,37.38276294,10
아름마루,1,1,127.3605662,37.75345713,2
아름지기,5,5,126.9737247,37.57764416,10
아리랑도가니탕,4,4,127.0247429,37.25605286,8
아리랑힐호텔 동대문,20,20,127.0166722,37.59365835,40
아리산채,4,4,126.8997427,37.57854154,8
아리수나라,3,3,127.0775874,37.55133953,6
아리아르,3,2,126.7846478,37.40665872,5
아리아콩나물국밥,4,4,127.3036053,37.36927364,8
아리아호텔,4,4,127.1281865,37.53805256,8
아리연,2,3,126.9769153,37.56162513,5
아리테호텔,5,5,126.9516109,37.27384203,10
아마,4,4,126.9532572,37.47924844,8
아마리오,3,4,127.0246028,37.51776414,7
아마츄어작업실 광장시장점,4,4,127.0005207,37.57180864,8
아마츄어작업실 시흥점,2,3,126.8039788,37.44662988,5
아만티호텔서울,4,4,126.918767,37.55703679,8
아만티호텔웨딩,5,5,126.9187532,37.55724581,10
아말피,5,5,127.1841506,37.47976652,10
아모레 성수,17,18,127.0590407,37.54454772,35
아모레퍼시픽그룹 본사,5,5,126.9684405,37.52858172,10
아모레퍼시픽미술관,12,14,126.9684584,37.52912413,26
아모하임,4,3,127.1045985,37.18402448,7
아바이왕순대,1,1,126.6735159,37.41665854,2
아버지가키운소아들이파는집,5,5,127.492384,37.67704593,10
아보고가,5,5,126.6610088,37.70338774,10
아보헌,5,5,126.9895832,37.58204167,10
아브뉴프랑 광교,3,3,127.0498153,37.29082153,6
아브뉴프랑 광명,5,5,126.8818445,37.41635832,10
아브뉴프랑 판교,8,8,127.1134185,37.39732621,16
아비꼬 대학로점,5,5,127.0031417,37.58253827,10
아비꼬 부평역점,5,5,126.7246481,37.49350719,10
아비꼬 안국역점,3,3,126.9861798,37.57725705,6
아빠곰탕 가평설악점,13,13,127.4850407,37.67844223,26
아산동양고속터미널,4,4,127.015348,36.78446199,8
아산마트 오송점,3,3,127.3300815,36.63237495,6
아산역,4,4,127.1040621,36.79212379,8
아셈호텔,10,10,126.6843178,37.64045979,20
아스카게임박물관,1,1,126.6955909,37.79165323,2
아스테리움용산오피스텔,4,4,126.9688572,37.52761416,8
아시아출판문화정보센터,5,5,126.6869995,37.70877893,10
아쎄르,4,4,126.9825205,37.5792838,8
아오리의행방불명 송도점,4,4,126.661021,37.37978257,8
아오리의행방불명 여의도점,4,4,126.9299895,37.52070124,8
아오이토리,12,12,126.929483,37.55471623,24
아우어베이커리 도산본점,2,3,127.0368901,37.52354988,5
아우어베이커리 롯데영등포점,5,5,126.9073215,37.51588328,10
아우어베이커리 삼송점,5,5,126.9015142,37.66030765,10
아우어베이커리 한남나인원점,3,3,127.004786,37.53652547,6
아우프글렛 연남점,3,4,126.925378,37.56450861,7
아울림,3,3,127.0436981,37.54698349,6
아웃백스테이크하우스 광명AK점,5,5,126.8828892,37.41868038,10
아웃백스테이크하우스 명동점,4,4,126.9837371,37.56534558,8
아웃백스테이크하우스 부평점,5,5,126.7225523,37.49101623,10
아웃백스테이크하우스 수원역사점,5,4,126.9997632,37.26666972,9
아웃백스테이크하우스 수원영통점,4,4,127.0741343,37.25514381,8
아웃백스테이크하우스 용산아이파크몰점,5,4,126.9654048,37.5293287,9
아웃백스테이크하우스 일산원마운트점,5,5,126.754363,37.66464656,10
아웃백스테이크하우스 파주점,3,4,126.6963561,37.76944113,7
아웃백스테이크하우스 하남스타필드점,9,9,127.2241729,37.54499121,18
아웃팅카페,5,5,126.9183858,37.775254,10
아워플레이스,5,5,127.1257046,37.42904767,10
아이노스,8,8,126.6919901,37.7118806,16
아이노스 출판단지점,4,5,126.6864574,37.70717016,9
아이뎁스 PC방,5,5,126.9942072,37.53426391,10
아이라이크마운틴,2,2,126.9989365,37.53303688,4
아이라이크마운틴 카페,4,4,128.3439707,37.0000843,8
아이러브신당동,8,9,127.0148329,37.56313652,17
아이마라,3,4,126.8922602,37.50425656,7
아이맛이야 장작철판구이 행주본점,3,3,126.8275773,37.60101181,6
아이비모텔,4,4,127.0348014,37.60055419,8
아이사구아,3,3,126.9853457,37.58173669,6
아이센스리그PC방 압구정점,3,2,127.0371674,37.52834763,5
아이센스리그PC방 응암오거리점,4,4,126.9156362,37.58944698,8
아이스무빙 송도한라웨스턴점,5,5,126.6289612,37.40603929,10
아이스크림할인점,5,5,126.6677227,33.54114523,10
아이스타일,7,7,126.6875339,37.70925065,14
아이아이리서치 바,4,4,127.0484407,37.54183153,8
아이엠도넛,5,5,126.7356075,37.3980392,10
아이엠베이글 광명테이크호텔점,5,5,126.8832082,37.41907534,10
아이엠어버거 하남점,4,4,127.2224426,37.54571888,8
아이와키즈풀빌라,4,4,127.4592376,37.7181319,8
아이존팝 광명철산점,5,5,126.8697911,37.47510978,10
아이파크몰,120,116,126.9645328,37.52881668,236
아이플러스안과의원,4,5,127.0256209,37.50118183,9
아인티오펜션,4,3,127.3706891,37.68378451,7
아재커피 북촌점,8,8,126.9870262,37.57927537,16
아제라호텔,8,9,126.6762956,37.41753116,17
아주대시외버스정류소,3,3,127.0448028,37.27425522,6
아지오호텔,8,8,127.5244406,37.80415929,16
아지트리,5,5,126.9195574,37.55453616,10
아차산,10,10,127.102742,37.5668445,20
아차산 4보루,5,5,127.1041456,37.57099505,10
아차산1보루,5,5,127.0997009,37.56201777,10
아차산로59,5,5,127.1148609,37.56367984,10
아차산생태공원,5,5,127.1008007,37.55171663,10
아차산역 5호선,6,6,127.089565,37.55224917,12
아차산큰바위얼굴,5,5,127.1088178,37.56123125,10
아침고요가족동물원,27,28,127.3615888,37.74813831,55
아침고요수목원,137,143,127.3516612,37.74300402,280
아침고요수목원입구,4,5,127.3528793,37.74433381,9
아쿠아가든 롯데월드몰점,9,9,127.1040262,37.51358709,18
아쿠아가든카페 미사점,5,5,128.7025375,36.3566683,10
아쿠아플라넷,3,3,126.7556469,37.6638418,6
아쿠아플라넷 광교,12,15,127.058097,37.28418611,27
아쿠아플라넷 일산,31,34,127.0842039,37.11996109,65
아쿠아플라넷63,15,15,126.9403293,37.5200582,30
아쿠아필드 고양,17,18,126.8967147,37.64793306,35
아쿠아필드 안성,13,13,127.1472512,36.99462872,26
아쿠아필드 하남,27,26,127.2234772,37.54582865,53
아크스테이션 2호점,3,3,126.9228945,37.54938108,6
아크앤북 미사현대점,4,4,127.2045814,37.55886608,8
아크앤북 신촌점,4,5,126.9365765,37.55676659,9
아크앤북 이태원점,5,5,126.9930989,37.52856051,10
아크테릭스 신세계 프리미엄 아울렛 시흥점,4,4,126.7359196,37.37987983,8
아크틱,5,5,126.9213925,37.54859802,10
아키나이제면 명동점,9,9,126.9823319,37.56295954,18
아키라백,5,5,126.9754228,37.57076453,10
아키비스트,14,14,126.9726702,37.58221196,28
아타리,3,4,127.0566637,37.53755713,7
아토믹워터파크,5,5,127.5193433,37.79118385,10
아토즈캠핑 용인점,5,5,127.1078319,37.29412754,10
아트린뮤지엄 카페,4,4,126.9163557,37.77371012,8
아트몬스터 명동역점,5,5,126.985368,37.56050744,10
아트박스 광명AK점,5,5,126.8826153,37.41901168,10
아트박스 대학로1호점,5,5,127.0003985,37.58343507,10
아트박스 수원인계점,4,4,127.0321598,37.26322157,8
아트박스 위례점,2,2,126.6852386,37.79040523,4
아트밸리 자작나무,4,4,127.2311804,37.93304609,8
아트선재센터,5,5,126.9818366,37.57957381,10
아트센터 인천,4,5,126.6262134,37.39324882,9
아트센터화이트블럭,3,3,126.6993544,37.78888163,6
아트스페이스 광교,8,9,127.0590006,37.28615804,17
아트스페이스 이색,3,2,126.9845724,37.57651443,5
아트스페이스 트인,4,5,126.766535,37.44280643,9
아트스페이스 합정,10,10,126.9086609,37.55009803,20
아트스페이스J,5,5,127.1062985,37.36488515,10
아트시티펜션2,4,4,126.9535178,37.74039397,8
아트앤초이스,3,2,126.9974599,37.5366769,5
아트원씨어터,10,10,127.0039805,37.58032477,20
아트원씨어터 1관,4,4,127.0039896,37.58031756,8
아트카페잉크,5,5,127.0027598,37.26440628,10
아트컨티뉴 고양파주갤러리,3,3,126.7629068,37.72932875,6
아트포레,5,5,126.6320243,37.39356167,10
아트포레스트,9,9,127.0030885,37.58249439,18
아트필드갤러리,5,5,126.8952598,37.51377387,10
아틀리에,4,4,126.9932137,37.53521892,8
아티장베이커스 서래점,5,5,126.9981544,37.49824732,10
아티장베이커스 타임빌라스점,5,5,127.0095471,37.37598632,10
아티장베이커스 파주점,12,12,126.9051617,37.77559367,24
아티장크로아상,4,4,126.9866141,37.57958526,8
아티제 광화문S타워점,3,2,126.9739334,37.56979474,5
아티제 도산로점,3,3,127.0360593,37.52264463,6
아티제 여의도롯데캐슬점,3,3,126.9263723,37.52025575,6
아티제 일원점,3,3,127.0852054,37.48832355,6
아티제 코엑스몰점,2,3,127.0591051,37.51144128,5
아펜즈커피 구리점,3,3,127.1129574,37.56236623,6
아프리카농장,5,5,126.653566,37.64815346,10
아피네오프닝포트,4,4,126.6308207,37.46991415,8
아하바호텔,4,4,126.9063928,37.5186216,8
악쓰는하마 코인노래연습장,6,6,127.1250317,37.55696674,12
악쓰는하마코인노래방,8,7,127.000942,37.58335938,15
안광반점,4,4,127.4246776,37.07621549,8
안국153,8,8,126.9849346,37.57651087,16
안국역 3호선,30,30,126.9854214,37.57650192,60
안국역 3호선 2번출구,3,3,126.9861436,37.5771327,6
안국역4번출구 주차장,3,3,126.9876515,37.57674815,6
안국정,3,3,126.9863053,37.5778337,6
안나리사 유리공방,5,5,127.2905109,37.74155246,10
"안녕, 미장원 부평점",5,5,126.7246099,37.49111475,10
안녕낯선사람,10,10,126.9186254,37.54980348,20
안녕식당,2,3,127.1281489,37.53987983,5
안녕인사동,37,40,126.9835189,37.57450272,77
안다르 스타필드고양점,5,4,126.8947784,37.64697721,9
안다즈 강남 더서머하우스,5,5,127.0288703,37.52541809,10
안다즈 서울강남,84,84,127.0288703,37.52541809,168
안다즈 서울강남 2층 식당,5,5,127.0289201,37.5254876,10
안다즈 서울강남 더서머하우스,15,15,127.0288703,37.52541809,30
안다즈 서울강남 미술 전시관,5,5,127.0288703,37.52541809,10
안다즈 서울강남 수영장,5,5,127.0289201,37.5254876,10
안다즈서울강남 조각보,5,5,127.0288657,37.52532079,10
안다즈호텔 서울강남 수영장,5,5,127.0289201,37.5254876,10
안동국시 기흥AK점,2,1,127.1167045,37.27452334,3
안동찜닭해물떡찜,3,3,127.0585975,37.51023779,6
안동휴게소 부산방향,5,5,128.6419844,36.55319637,10
안동휴게소 춘천방향,3,3,128.6451831,36.55341537,6
안산,5,5,126.9458808,37.57699407,10
안산갈대습지,2,2,126.8397481,37.27371553,4
안산다문화거리,5,5,126.7905446,37.3296254,10
안산대부광산퇴적암층,10,10,126.6484691,37.1986958,20
안산문화예술의전당,5,5,126.8225666,37.32007996,10
안산버스터미널,13,13,126.8462698,37.31684779,26
안산복합휴게소 인천방향,20,20,126.8186227,37.35095408,40
안산산업역사박물관,4,4,126.8169208,37.32299791,8
안산시 도시정보센터,5,5,126.8449023,37.29827568,10
안산자락길,9,9,126.9481663,37.57542286,18
안산화랑공원,4,4,126.8119601,37.32429122,8
안상철미술관,5,5,126.9569652,37.77835209,10
안성구포동성당,3,3,126.4874511,33.5175173,6
안성깍두기 경기광주점,5,5,127.25971,37.40681558,10
안성남사당 바우덕이풍물단,4,5,127.3093965,37.03142409,9
안성맞춤 남사당바우덕이축제,6,6,127.3101877,37.03307729,12
안성맞춤랜드,13,15,127.3101696,37.03304851,28
안성맞춤랜드 숲속공연장,4,4,127.3091686,37.03231945,8
안성맞춤랜드 잔디공원,4,4,127.309689,37.03314347,8
안성맞춤박물관,5,5,127.2283507,37.01124789,10
안성맞춤포도축제,3,2,127.2567736,36.95142999,5
안성맞춤휴게소 제천방향,4,3,127.2739876,36.96810126,7
안성숲속빌리지,3,3,127.4380974,37.06240201,6
안성장터국밥,5,4,128.9191753,37.79482074,9
안성종합버스터미널,15,14,127.2936082,37.01223615,29
안성집,5,5,127.4892231,37.93584914,10
안성칼국수,5,5,127.2593579,37.00762312,10
안성팜랜드,89,92,127.1935166,36.99131662,181
안성향교,3,3,127.2764091,37.01385974,6
안성휴게소 부산방향,15,14,127.1446898,37.01355638,29
안성휴게소 서울방향,9,9,127.1325866,37.07667369,18
안스베이커리 구월본점,3,3,126.7107042,37.44936486,6
안스베이커리 송도점,31,31,126.6450178,37.39167952,62
안스베이커리 스타필드 하남점,4,5,127.2240145,37.54461849,9
안스베이커리 연수점,5,5,126.6738742,37.41633877,10
안스베이커리 일산점,3,3,126.7544182,37.66437998,6
안암,4,4,126.9844623,37.579399,8
안암역 6호선,4,4,127.0292334,37.58630742,8
안양 농수산물도매시장,4,5,126.9700964,37.3818504,9
안양병목안캠핑장,5,5,126.9107355,37.3825341,10
안양새물공원,3,3,126.8908643,37.4173527,6
안양역,5,5,126.9226438,37.4018568,10
안양역시외버스정류장,1,1,126.9217184,37.4011534,2
안양예술공원,43,42,126.9197703,37.41906166,85
안양예술공원음식문화거리,4,4,126.9193927,37.41822616,8
안양일번가지하상가,4,3,126.9217368,37.400793,7
안양중앙시장,15,15,126.9199961,37.39787974,30
안양천,10,10,126.9036159,37.452977,20
안양천 가족정원,5,5,128.4384828,38.21491811,10
안양천합수부,10,10,126.8780018,37.55381578,20
안양파빌리온,15,15,126.9256103,37.41946103,30
"안정로데오거리, 코코살사버거앤타코",5,4,127.1147467,36.998928,9
안정리 로데오거리,3,3,127.0451301,36.96024134,6
안정리커피,5,5,127.0481133,36.95801809,10
안젤리미술관,1,2,127.2315768,37.18429307,3
안중농협하나로마트 본점,4,4,126.9257047,36.97632009,8
안쪽쪽갈비 사상본점,4,3,128.9835539,35.16591534,7
안테룸 서울,12,12,127.0252253,37.51886323,24
안평역 부산4호선,5,4,129.171763,35.23736861,9
안효공심온선생묘,4,4,127.0530583,37.2966192,8
안흥지,11,12,127.4501532,37.27695791,23
안흥지 애련정,5,5,127.4505796,37.27736716,10
알디프,3,4,126.9293908,37.5558489,7
알라딘중고서점 가로수길점,5,5,127.02299,37.51839156,10
알라딘중고서점 대학로점,5,5,126.9988271,37.58268904,10
알라딘중고서점 수원점,5,5,127.0013529,37.26597591,10
알라딘중고서점 인천송도점,5,5,126.6565852,37.3809447,10
알라딘중고서점 잠실롯데월드타워점,7,7,127.1042103,37.51498168,14
알라보 석촌호수점,3,3,127.108233,37.51059828,6
알로하피크닉&키즈카페,4,4,126.5761565,37.28787824,8
알로할로,4,4,126.9055482,37.55330043,8
알리에키즈풀빌라,3,3,127.457798,37.96836132,6
알멕스랜드,10,10,127.0070112,38.07310796,20
알베르,4,4,127.0281197,37.50297967,8
알비,5,5,127.0424899,37.5476768,10
알앤디69,9,9,127.0120344,37.28439438,18
알지비버거(rgbburger),5,5,126.9839192,37.54476411,10
알파 안국역점,4,4,126.9850105,37.57630725,8
알페도,13,17,126.9932341,37.53427287,30
알피,3,4,126.9718787,37.57936463,7
암사종합시장,3,3,127.1288196,37.55086047,6
압구정 스시유겐,3,4,127.0574885,37.28472343,7
압구정로데오거리,16,14,127.039152,37.52675582,30
압구정로데오역 수인분당선,19,19,127.0406028,37.52751848,38
압구정역 3호선,4,4,127.0285087,37.52649127,8
압구정탑바,3,3,127.0320618,37.5285924,6
압구정토끼굴,3,4,127.0417969,37.53064004,7
앗싸곱창 본점,5,5,127.0452359,37.74677422,10
앙꼬,3,3,127.0428199,37.51518567,6
앙띠브호텔,3,3,126.7869721,37.644264,6
앞마당닭발,5,5,127.0933957,37.81984999,10
애관극장,3,4,126.6298365,37.4723492,7
애니메이션박물관,1,1,127.6919248,37.89302159,2
애니메이트 홍대점,18,17,126.9264917,37.55773922,35
애니플러스샵 서울1호점,12,12,126.9123456,37.55103516,24
애드커피,1,1,126.9990039,37.56808572,2
애성회관,3,3,126.9789138,37.56240937,6
애슐리퀸즈 롯데백화점 청량리점,5,5,127.0481717,37.58097093,10
애슐리퀸즈 롯데백화점김포공항점,5,5,126.8032418,37.56303477,10
애슐리퀸즈가든 가평점,10,10,127.3960319,37.76060143,20
애오개역 5호선,5,5,126.9566694,37.55341315,10
애정마라샹궈 본점,3,3,127.0172391,37.59216263,6
애즈라이크,3,4,126.973301,37.57840811,7
애즈유라이크잇,2,2,126.976657,37.5533064,4
애플밸리펜션,4,4,127.3589402,37.75417925,8
애플약국,5,5,126.7455039,37.66279519,10
애플타운,4,4,127.4896843,36.90612136,8
애플하우스 이수,4,4,126.9805748,37.48627495,8
애호랑,5,5,126.8305401,37.55289225,10
앤드밀 성수점,3,3,127.0513719,37.54423866,6
앤드테라스 스타필드하남점,5,5,127.2233406,37.54555861,10
앤드테라스 파주점,5,5,126.7195103,37.74767447,10
앤디보니,4,4,126.5066159,36.32058712,8
앤디스커피,5,5,126.9267352,37.5564041,10
앤조이터키,5,5,126.6977976,37.78754783,10
앤트러사이트 서교점,5,5,126.9116794,37.55552163,10
앤트러사이트 연희점,5,5,126.9328528,37.5696713,10
앤티앤스프레즐 스타필드안성점,4,4,127.1470546,36.99464519,8
앨리,3,3,126.9422932,37.55800209,6
앨리스 라운지,2,2,126.7362911,37.39923367,4
앨리스노래연습장,5,5,127.0059303,37.26887172,10
앨리스키친,5,5,127.08909,36.98894312,10
앨리스호텔,3,3,127.0276977,37.26610784,6
앨리웨이 광교,10,13,127.0605179,37.27408334,23
앨리키친,3,4,127.0054895,37.56351034,7
앰배서더 서울풀만호텔,10,10,127.0021742,37.56026776,20
앰배서더서울풀만 더셰프스테이블,5,5,127.0022647,37.56007855,10
앳더팔당,5,5,127.2889117,37.52809831,10
앵커1883,1,1,126.6184063,37.47366795,2
야끼니꾸 소량,5,5,126.9129721,37.55432426,10
야끼니꾸소량 경복궁점,5,5,126.9705089,37.57929222,10
야끼화로 송도점,8,10,126.6457171,37.3928097,18
야당곱창,2,2,126.7601048,37.71143972,4
야당역 경의중앙선,4,4,126.761454,37.71261102,8
야당역 환승주차장,5,5,126.761383,37.71388935,10
야마다야,4,4,127.1223511,37.33996522,8
야반,4,4,127.4256072,37.29027947,8
야사이마끼쿠이신보,4,4,127.0242796,37.51868683,8
야인시대수영장,5,5,126.7422012,37.508703,10
야젠 2호점,4,3,126.9914422,37.57164615,7
야코리아호스텔 강남점,2,2,127.0437435,37.50458862,4
야코리아호스텔 동대문점,24,24,127.0130881,37.55978502,48
야키토리 엔,5,5,126.91988,37.54920608,10
야키토리리,5,5,126.9572933,37.47928781,10
야탑역 수인분당선,18,18,127.128743,37.41137364,36
야탑포토,3,4,127.1276274,37.41163434,7
약사사,2,3,126.7128604,37.47185931,5
약수동산,5,5,127.4551634,37.50770853,10
약수역 3호선,5,5,127.0108917,37.5545054,10
약수촌가든,5,5,127.187358,37.73122383,10
약수터식당,5,5,127.1900889,37.06017166,10
얌샘김밥 길동점,3,4,127.1415796,37.53855624,7
얌샘김밥 인천루원시티점,4,4,126.6898948,35.95542207,8
얌얌카츠,5,5,127.1266941,37.53602152,10
양강섬,4,4,127.480393,37.4955803,8
양근휴게소 인증센터,4,5,127.4846769,37.49808559,9
양동쌍학시장,2,1,127.7539994,37.42034875,3
양명교,4,3,126.9207371,37.4063246,7
양벌우림아파트,5,5,127.2595317,37.37705708,10
양산휴게소,3,3,129.0695568,35.43667135,6
양서농협 두물머리 로컬푸드직매장,23,23,127.3190916,37.54079046,46
양서농협하나로마트 국수점,7,7,127.4019922,37.51353269,14
양서농협하나로마트 본점,15,15,127.3190619,37.54576043,30
양서농협하나로마트 서종점,4,4,127.3517249,37.60277603,8
양수리빵공장,13,12,127.32284,37.5433445,25
양수리우리농원펜션,5,5,127.3272306,37.55478037,10
양수리전통시장,9,8,127.3199163,37.54446429,17
양수리전통시장5일장,3,3,127.3198543,37.5448305,6
양수면옥,2,2,127.3215594,37.54762953,4
양수역 경의중앙선,8,8,127.3291384,37.54596343,16
양양종합여객터미널,5,5,128.6297767,38.08529403,10
양재근린공원,3,3,127.0424424,37.47170321,6
양재동꽃시장,7,7,127.0395686,37.46713068,14
양재시민의숲,5,5,127.0358717,37.47092331,10
양재시민의숲역 신분당선,5,5,127.0384713,37.47013321,10
양재역 3호선,16,16,127.0335342,37.48427065,32
양재역내 환승통로에 있는 던킨도너츠,4,4,126.3104746,33.46233117,8
양재천,4,4,127.0465952,37.48180376,8
양주 천만송이천일홍축제,5,5,127.0806335,37.78565178,10
양주 천일홍 축제(나리공원),3,4,129.1632326,35.16011742,7
양주나리농원,14,16,127.0838332,37.78820108,30
양주대모산성,2,2,127.0109938,37.78704832,4
양주송천캠핑장,5,5,126.9380894,37.77412718,10
양주시립민복진미술관,14,14,126.9493285,37.7311564,28
양주시립장욱진미술관,17,19,126.9484564,37.73243901,36
양주역 1호선,4,4,127.0447213,37.77414216,8
양주전통문화축제,3,3,127.0315597,37.78616527,6
양주탑글램핑,3,3,127.1018472,37.81102441,6
양주패밀리캠핑장,8,8,127.0952944,37.8090586,16
양주패션복합단지,5,5,127.0524968,37.8311668,10
양주향교,5,5,127.0326951,37.78636317,10
양주휴게소,13,13,126.9157727,37.67918251,26
양지말화로구이,10,10,127.8313103,37.65950062,20
양지촌,10,10,127.8890053,37.69024561,20
양지파인리조트,2,2,127.295089,37.21314406,4
양키스그릴,4,4,126.8949791,37.51473589,8
양키통닭,12,14,126.8927602,37.5136635,26
양평 양때목장,3,3,127.6284028,37.5151171,6
양평 양떼목장,4,4,128.5464657,36.00677192,8
양평곤충박물관,5,7,127.4491893,37.50920002,12
양평광탄1991고바우설렁탕,5,5,127.629673,37.50728559,10
양평군립미술관,6,6,127.484083,37.49716901,12
양평농협하나로마트 옥천점,5,5,127.459144,37.52017192,10
양평등갈비,3,3,127.4915443,37.45886369,6
양평만남의광장,4,4,127.3939614,37.50836639,8
양평맑은술도가,4,5,127.6044016,37.51337586,9
양평물맑은시장,19,21,127.4926951,37.49074533,40
양평부림오토캠핑장,9,10,127.5499577,37.44051414,19
양평신내서울해장국,12,12,126.8633689,37.45074279,24
양평양떼목장,5,5,126.7048176,35.98680644,10
양평역,36,35,127.4913618,37.49279254,71
양평역 5호선,4,4,126.8864193,37.52557964,8
양평온누리캠핑장,4,4,127.4336913,37.64726039,8
양평장터마트,5,5,127.4921789,37.49048619,10
양평친환경로컬푸드 양평직영점,2,3,127.4925662,37.49092066,5
양평프라자주유소,3,3,127.4427079,37.51138689,6
양평해장국,2,3,128.3701669,36.98652726,5
양평해장국 마장호수점,3,3,126.9370975,37.77664935,6
양평휴캠핑장,3,3,127.7691827,37.54038865,6
양푼이김치찌개,4,4,127.1123527,37.51237572,8
양화한강공원,19,19,126.9029383,37.53780834,38
어거스트 청평,10,10,127.4973968,37.70117536,20
어거스트올리브,4,5,127.1215439,37.51096466,9
어거스트캠핑장,10,10,127.2275326,37.81817888,20
어고,5,5,126.9677638,37.58141064,10
어나더쥬얼리,8,8,127.1742155,37.58697535,16
어나더플레이스,4,5,127.0977692,37.85319616,9
어니언,5,5,127.0582081,37.5447824,10
어니언 4호점,5,5,127.0015281,37.56982644,10
어니언 안국점,3,4,126.9865737,37.5776319,7
어니언컴퍼니,11,12,127.0582081,37.5447824,23
어둠속의대화,14,15,126.9848008,37.58333498,29
어라운드데이,5,5,127.0412696,37.54686183,10
어라운드에잇,5,5,126.8965031,37.85707437,10
어락,10,10,127.0678693,38.04356361,20
어랑손만두,3,4,127.2242429,37.63628483,7
어랑추,8,8,127.1375411,37.61167848,16
어로프슬라이스피스,12,12,127.1910072,37.2627565,24
어로프슬라이스피스 퇴촌점,4,4,127.3854267,37.47622157,8
어머나바지락손칼국수,4,4,126.5707843,37.26005027,8
어머조개닭,4,3,127.3408854,37.61376382,7
어메이징파크,13,13,127.1422054,37.92657256,26
어바웃네이처,4,3,127.3544696,37.23938542,7
어바웃브레드,5,5,127.1265804,36.99412814,10
어반81,4,4,127.0485734,37.51261378,8
어반그린스,5,5,126.7612917,37.71581454,10
어반런드렛 더 테라스,1,4,127.104871,37.31089938,5
어반리프,4,5,127.1031735,37.23838877,9
어반바이브,5,5,129.3774943,36.02706533,10
어반스테이 동탄,9,10,127.0706519,37.20406647,19
어반스테이 인천송도,35,34,126.6280094,37.40527584,69
어반아지트,3,3,126.7236843,37.49466435,6
어반이스트호텔,12,12,126.8739497,37.64812717,24
어반포트 케이스퀘어시티 주차장,5,5,126.9802093,37.56851654,10
어반플랜트 서빙고,5,5,126.9931935,37.52056772,10
어반플랜트 합정,4,4,126.9171881,37.54789417,8
어반플레이스,5,5,127.370404,37.68823621,10
어부네옛매운탕,5,5,126.5260174,33.51158514,10
어부의밥상,4,5,127.1856137,37.00644217,9
어부집,4,4,126.8192404,37.89673631,8
어스17카페,5,5,127.7939642,37.93276406,10
어썸마운틴,7,7,126.926489,37.56044221,14
어울더울,5,5,126.9930376,37.40943245,10
어울림공원,4,4,127.1285093,37.6442611,8
어쩌다산책,9,9,127.0040168,37.58246553,18
어천역 수인분당선,3,3,126.9088,37.25008785,6
어천저수지,5,5,126.9166588,37.2539429,10
어촌마을,5,5,126.8440619,37.5222841,10
어텐디 북촌점,7,8,126.9860322,37.57916173,15
어텐디드가든카페,5,7,127.5578406,37.89451901,12
어텐션,3,3,126.9223958,37.55007272,6
어퍼앤언더,5,5,127.0277261,37.50273739,10
언남중학교,2,3,127.0441476,37.47255674,5
언노운다이너,2,2,127.0454864,37.48418646,4
언더스타,3,3,126.9219401,37.55296642,6
언더스탠드에비뉴,4,4,127.0436872,37.54356474,8
언더스테이지,10,10,127.0006789,37.53663008,20
언덕위에제빵소,4,5,127.1655885,37.78706943,9
언덕카페,9,9,126.9045941,35.38071114,18
언올드첨,2,4,127.0047533,37.26971875,6
언칼국수 금촌본점,4,3,126.7747779,37.7619418,7
언톨드,5,5,127.2979439,37.23120648,10
언포모,3,4,127.0410774,37.54722229,7
얼레이호텔,2,4,127.0977194,37.28848862,6
얼맥당 합정점,3,3,126.912123,37.54978531,6
얼스어스 서촌점,9,9,126.9712312,37.58533806,18
엄마백반,3,3,127.0290275,37.51077134,6
엄마손김밥,5,5,127.0188798,36.78682961,10
엄마손칼국수,4,4,127.0802554,37.67103052,8
엄마의거리,5,5,126.683906,37.64031813,10
엄용백돼지국밥 종각점,4,4,126.9857823,37.57189428,8
업스테어키친,4,4,126.7361275,37.72905922,8
업스테이지,8,9,127.0043473,37.58007248,17
엉베흐,5,5,126.8907052,37.50342981,10
엉클드파리,4,4,127.2790133,37.19226067,8
엉클인더키친 2호점,2,3,126.6610021,37.37973386,5
"엉클인더키친 트리플스트리트점, 트리플스트리트",3,4,126.6613459,37.3797327,7
에그궁,15,15,127.0102709,37.28542173,30
에그릭,5,5,126.7761104,37.49678818,10
에그셀런트 선릉역점,4,4,127.0503043,37.50301556,8
에그슬럿 여의도점,7,5,126.9283953,37.52582158,12
에그앤플라워,5,5,126.9844634,37.54535434,10
에그옐로우 주차장,4,4,126.95219,37.48091939,8
에너지사이언스,5,5,127.037329,37.48258192,10
에델바이스 스위스 테마파크,17,16,127.4474799,37.66778896,33
에딧76,5,5,126.9278228,37.52705561,10
에뚜왈,4,4,127.0222216,37.52131456,8
에르메스 신세계백화점 본점,4,3,126.9810851,37.56089426,7
에르제성수,5,5,127.0589316,37.54389455,10
에리카,5,5,127.029713,37.58517565,10
에맥앤볼리오스 롯데월드몰점,3,3,127.1038905,37.51355567,6
에머이 남부터미널점,5,5,127.0169498,37.48469947,10
에머이 대학로점,2,3,127.00377,37.58162581,5
에머이 판교점,4,3,127.1109724,37.39660141,7
에메랄드그린,5,5,127.1510561,37.04630439,10
에버그린펜션,5,5,127.1981729,37.2706036,10
에버랜드,403,410,127.1997156,37.29604684,813
에버랜드 1주차장,5,4,127.2172475,37.29347451,9
에버랜드 T익스프레스,4,5,127.202818,37.28992661,9
에버랜드 그랜드엠포리엄,8,9,127.2035556,37.294153,17
에버랜드 라시언메모리엄,5,5,127.2037829,37.29478694,10
에버랜드 로스트밸리,10,10,127.2079563,37.29169814,20
에버랜드 롤링엑스트레인,5,5,127.2012654,37.2930144,10
에버랜드 매직타임레스토랑,5,5,127.2025314,37.29072361,10
에버랜드 매표소,5,5,127.2046772,37.29518185,10
에버랜드 멀린스스낵,3,4,127.1989982,37.29204872,7
에버랜드 아마존익스프레스,15,15,127.2048028,37.29159191,30
에버랜드 알파인종합식당,5,5,127.2045028,37.29074185,10
에버랜드 애니멀원더스테이지,5,5,127.2034195,37.29220339,10
에버랜드 에버마트,5,5,127.2050041,37.29428025,10
에버랜드 에스파 포토존,5,5,126.2404729,33.39388856,10
에버랜드 오리엔탈누들레스토랑,7,7,127.2031894,37.29385449,14
에버랜드 정문,10,10,127.2044017,37.29508862,20
에버랜드 차이나문,5,5,127.2004067,37.29158502,10
에버랜드 카니발광장,5,5,127.202108,37.2909514,10
에버랜드 판다월드,13,13,127.202822,37.29309464,26
에버랜드 포시즌스가든,5,5,127.2004029,37.29098313,10
에버랜드 한가람,9,10,127.2012951,37.29060318,19
에버랜드 홈브리지캐빈호스텔,14,14,127.1980689,37.28900478,28
에버랜드 홈브리지캐빈호스텔 신관,4,4,127.1976705,37.2897515,8
에버렌드 랩터 레인저,5,5,127.2035836,37.29112908,10
에버리움펜션,3,2,127.220907,37.31616118,5
에버오렌지펜션,2,2,127.2180452,37.28618005,4
에버찜질사우나,5,5,127.2235461,37.28084646,10
에베레스트 레스토랑 동대문점,3,4,127.0125017,37.57257202,7
에베레스트레스토랑 동대문점,5,5,127.0125017,37.57257202,10
에브리데이토스트,5,5,127.0189357,37.57137284,10
에브리띵베이글,3,3,126.9296172,37.56777823,6
에스부리또,1,3,126.7950138,37.3307519,4
에스엔에스피씨,4,4,126.9234489,37.55607765,8
에스엠여주375,3,3,127.6179759,37.24218513,6
에스텔라,13,12,126.5780726,37.26603682,25
에스팩토리,5,6,127.0595733,37.54264454,11
에스프레소바 투또톤토,5,5,127.0714031,37.54214243,10
에스프레소플래닛,4,4,126.7419205,37.35126573,8
에스플래닛,5,5,127.0449509,37.46804868,10
에스호텔,5,5,126.7873988,37.48472114,10
에어비앤비,10,10,127.7282284,37.8821512,20
에어비앤비 갤럭시2,4,4,127.0609426,37.0666469,8
에어비앤비 숙소,21,21,127.155235,35.8236165,42
에어비앤비 쉼표집,5,5,126.907876,37.5156837,10
에어비앤비(바베큐 가능한 독채 전원주택),5,5,129.3338984,35.53623204,10
에이든 바이 베스트웨스턴 청담,2,2,127.0304767,37.51997473,4
에이랜드 잠실점,3,2,127.1040841,37.51368435,5
에이랜드 홍대점,3,4,126.921132,37.55310464,7
에이셉피자,5,5,127.0492966,37.54431613,10
에이스모텔,6,6,127.5949467,37.48442718,12
에이스하드웨어 용산점,3,3,126.9592696,37.53338306,6
에이스호텔,6,5,127.2395086,37.51847514,11
에이에이플레이스,3,3,126.922314,37.55472542,6
에이원호텔,6,8,127.1704295,37.6083884,14
에이치씨어터,1,1,127.0047185,37.57760014,2
에이커,5,5,126.9694673,37.57955324,10
에이큐브호텔,18,17,127.0017295,37.5661792,35
에일당,3,3,126.9900859,37.57351471,6
에잇비돌체 잠실월드타워점,5,3,127.1003147,37.51332,8
에잇세컨즈 건대스타시티점,3,3,127.0712157,37.53899806,6
에잇세컨즈 롯데몰 수원점,4,4,126.9972943,37.26401703,8
에잇세컨즈 명동점,4,4,126.9841721,37.56356887,8
에즈파파,2,2,126.9198156,36.92018916,4
에코의서재,5,5,127.1100191,37.32148816,10
에코코인노래연습장,3,3,126.7406868,37.44405,6
에코타운,4,4,127.2272559,37.27333195,8
에쿠스모텔,1,1,126.9940081,37.30679102,2
에키노마에,4,4,126.7234861,37.49044899,8
에프라운지,5,5,127.1076479,37.50639203,10
에피그램 올모스트홈,5,5,126.9896626,37.53987323,10
에피소드706,5,5,127.5422619,37.51240258,10
엑스라이프,5,5,128.595514,35.87565702,10
엑스익스프레스 성수낙낙점,5,5,127.0652799,37.5467681,10
엑스코 동관,5,5,128.6146327,35.90811549,10
엑스코 서관,5,5,128.6130296,35.90717733,10
엑스코서관 창의융합교육 전시실,5,5,126.618189,37.47483495,10
엑시토,5,5,126.7901006,37.49456226,10
엔321(n321),5,5,127.006445,37.57970298,10
엔메르,5,5,127.1446601,37.55060066,10
엔보트 고양점,4,4,126.8696752,37.60417242,8
엔살라다 선릉본점,5,5,127.048384,37.50665642,10
엔제리너스 롯데백화점 동탄점,5,5,127.0979306,37.20069965,10
엔제리너스 명동시티호텔점,3,3,126.9878886,37.56698589,6
엔제리너스 수서환승통로점,3,3,127.1044788,37.48529511,6
엔젤코인노래연습장 건대점,5,5,127.070466,37.54074645,10
엔터식스 안양역점,24,23,126.9230011,37.40143536,47
엔터식스 왕십리역점,5,5,127.0383737,37.56200677,10
엔테라스 카페,5,5,126.9878685,37.55112113,10
엔틸로프,12,14,126.5538574,37.28174136,26
엔피어싱,10,10,126.6185391,35.42851842,20
엘레강스모텔,3,3,127.1084028,37.27387528,6
엘렌뮤즈,5,5,126.9709233,37.57914636,10
엘리시안강촌,7,7,127.5899172,37.82214513,14
엘리제펜션,10,10,127.5033428,37.71521239,20
엘리트농부 로컬푸드,5,5,126.785231,37.59724469,10
엘리펀트플라잉,10,10,126.6965598,37.78819695,20
엘마트 광주점,5,5,127.3105797,37.36430531,10
엘마트 구리점,5,5,127.1415515,37.61225037,10
엘마트 대부도점 주차장,4,4,126.5706603,37.27177319,8
엘마트 용인점,4,4,127.0766569,37.32288045,8
엘비스분식,2,1,126.696046,37.79057055,3
엘비엔,4,4,127.1910612,37.56553087,8
엘샌드위치,3,3,126.981763,37.57505081,6
엘에이피자,3,3,126.6702646,37.52761207,6
엘타워,3,3,127.0356262,37.48234278,6
엠바웃,5,5,126.7221964,37.49062256,10
엠브로돈까스 신촌점,4,4,126.9382167,37.55786307,8
엠블럭,5,5,127.3613675,37.75954878,10
엠앤럭키호텔,40,41,126.9908989,37.57134337,81
엠플라자,3,3,126.9851683,37.56260313,6
엠플레이그라운드 건대점,4,4,127.0702623,37.5407718,8
엠플레이그라운드 연세점,3,2,126.937135,37.55619205,5
엠플레이그라운드 홍대1호점,5,5,126.922938,37.55549348,10
여강길 10코스(천년도자길),4,5,127.6309912,37.31519324,9
여기런던,4,4,127.0564299,37.53966558,8
여내울,2,2,127.6131358,37.28243581,4
여내울 수월정,5,5,127.6113255,37.24694466,10
여락식당,4,4,126.688593,37.47913564,8
여래암,4,4,127.0121202,37.28501699,8
여명 본점,4,4,126.9784966,37.19312068,8
여산휴게소 순천방향,7,7,127.10233,36.0484763,14
여수공항,14,14,127.6139364,34.83997745,28
여수종합버스터미널,10,10,127.716998,34.75820211,20
여울목펜션,2,3,126.8660447,33.36961132,5
여유당,5,5,127.300125,37.51672946,10
여의나루선착장,9,9,126.9352981,37.52747981,18
여의나루역 5호선,22,22,126.932986,37.52714695,44
여의도 한강공원,5,5,126.4079226,33.45274787,10
여의도KBS홀,8,8,126.9152214,37.52582728,16
여의도계절광장,5,5,126.9375547,37.52375087,10
여의도곱창,5,5,126.9330573,37.52324745,10
여의도공원,45,44,126.9223482,37.52613492,89
여의도공원 문화의마당,8,8,126.9203361,37.5246307,16
여의도공원 한국전통의숲,5,5,126.9272776,37.52923029,10
여의도샤브샤브,2,3,126.9269329,37.52076787,5
여의도역 5호선,5,5,126.924398,37.52177539,10
여의도역 9호선,21,21,126.924661,37.52117009,42
여의도역근처,3,3,126.2949908,33.25481888,6
여의도한강공원,281,280,126.9351293,37.5263886,561
여의도한강공원 제1주차장,5,5,126.9398634,37.52266186,10
여자만숯불장어구이,5,5,126.7787164,37.70154469,10
여장군 본점,5,5,127.1094819,37.32761929,10
여주곤충박물관,8,8,127.6633314,37.25967017,16
여주그린수상레저,5,5,127.676389,37.29638057,10
여주농촌테마공원 본관,8,8,127.6112958,37.24731424,16
여주리틀야구장,5,5,127.6389059,37.30291852,10
여주마조렐글램핑리조트,8,8,127.6559293,37.24896215,16
여주맛있는휴게소 강릉방향,6,7,127.5696329,37.23789265,13
여주맛집초계국수N수제왕돈까스,5,5,127.6538376,37.29852288,10
여주박물관,3,4,127.6533919,37.29967144,7
여주보,5,5,127.6057652,37.3266599,10
여주보 인증센터,4,4,127.6052246,37.32636353,8
여주보문화관,2,2,129.1189761,35.15319327,4
여주솥반,5,5,127.6349509,37.29923931,10
여주오곡나루축제,12,13,127.6557979,37.29931214,25
여주프리미엄아울렛 WEST,4,4,127.6100035,37.23912332,8
여주한글시장,16,16,127.6344166,37.29752934,32
여주휴게소 서창방향,7,8,127.5700509,37.23982696,15
여주휴게소주유소 인천방향,5,5,127.5687835,37.23973935,10
여호와의증인 이태원왕국회관,5,5,126.9971533,37.53502987,10
역곡역 1호선,19,17,126.8120593,37.48531436,36
역대짬뽕 송탄점,3,3,127.0530711,37.06702868,6
역삼도서관,8,8,127.0332825,37.49537384,16
역삼역 2호선,8,8,127.0364695,37.50067442,16
역전우동0410 대전역점,4,4,127.4324625,36.33206776,8
역전우동0410 위례중앙점,3,3,127.1428071,37.47497629,6
역전우동0410 일산웨스턴돔점,3,3,126.7728757,37.65684153,6
역전할머니맥주 동탄영천점,4,4,127.1134106,37.20580922,8
역전할머니맥주 서울독산점,5,5,126.899952,37.46935468,10
역전할머니맥주 서울신천점,4,4,127.0810872,37.51019566,8
역전할머니맥주 서울한남점,5,5,127.006019,37.53280247,10
역전할머니맥주 신논현점,4,4,127.0242578,37.50724048,8
역전할머니맥주 에버랜드점,5,5,127.2169783,37.28613516,10
역전할머니맥주 위례광장점,5,5,127.1426615,37.47213739,10
역전회관,7,7,126.9470075,37.54292158,14
연경,2,2,126.93552,37.55874461,4
연경 차이나타운본점,18,19,126.6198311,37.47561511,37
연곡해변 솔향기캠핑장,10,10,128.8532874,37.85893104,20
연교,10,10,126.9266712,37.56160461,20
연그리다,3,3,126.7553468,37.48883979,6
연꽃언덕,10,10,127.3255721,37.55023682,20
연꽃테마파크,4,4,126.8072252,37.40224755,8
연남동벚꽃집,4,4,126.9227133,37.56264004,8
연남방앗간,12,13,126.9231621,37.56205648,25
연남취향,4,4,126.9257216,37.56046516,8
연남토마 본점,1,3,126.9214625,37.55950735,4
연돈볼카츠 부천중동점,8,8,126.7625206,37.50298939,16
연돈볼카츠 서현점,4,3,127.1239092,37.38850549,7
연리희재,4,4,126.713352,37.76841065,8
연무대 관광안내소,5,5,127.0236865,37.28783099,10
연무동공영주차장,3,4,127.0205244,37.28775589,7
연무정매점,3,3,127.0236865,37.28782017,6
연무정식당,3,3,127.0236312,37.2878373,6
연밀,3,4,127.0173878,37.28133739,7
연밭,4,4,127.3265425,37.54336856,8
연백식당,5,5,126.6035753,37.45655767,10
연산내과의원,5,5,129.0859845,35.17553074,10
연서시장,5,5,126.9219569,37.61932275,10
연세대학교 국제캠퍼스,14,12,126.6705647,37.38170529,26
연세대학교 노천극장,4,4,126.9395755,37.56541052,8
연세대학교 신촌캠퍼스,11,12,126.9389335,37.5643326,23
연세대학교국제캠퍼스 나눌샘,3,3,126.6710899,37.38242756,6
연세본안과,4,4,127.016431,37.48531133,8
연신내역 3호선,15,15,126.9211007,37.61920325,30
연안식당,2,2,126.9384582,37.5256831,4
연안주차장,3,3,126.6046161,37.45724232,6
연양정원,4,4,127.665556,37.29212158,8
연인산,10,10,127.4143917,37.89875571,20
연인산 계곡,5,5,127.5033824,37.9000306,10
연인산 탐방안내소,5,5,127.4855175,37.84763382,10
연인산도립공원,13,14,127.4439417,37.87628934,27
연인산등산로,5,5,127.4072561,37.87296234,10
연인산리조트,3,3,127.5023729,37.90307183,6
연인산잣닭갈비,10,10,127.5090636,37.83575002,20
연제네 수원인계점,9,9,127.0351434,37.26466059,18
연천 로하스파크 생태습지,3,3,127.0453179,38.1311734,6
연천 전곡리국화축제,10,10,127.0634588,38.01775639,20
연천 전곡리유적 구석기체험숲,8,9,127.0664568,38.01340506,17
연천5일장,3,3,127.0758014,38.09968237,6
연천고랑포구역사공원 역사문화전시관,5,5,126.8472659,37.98798513,10
연천구석기축제 및 국화꽃,4,4,127.0612377,38.01448179,8
연천당포성,12,12,126.9858778,38.02312777,24
연천미라클타운,12,12,127.0449197,38.13061753,24
연천수레울아트홀,4,4,127.0800116,38.10899142,8
연천양원리고인돌,3,3,127.0342225,37.99631202,6
연천은대리성,5,5,127.0597425,38.02431708,10
연천재인폭포 오토캠핑장,12,12,127.1274965,38.06529112,24
연천전곡리선사유적지,23,25,127.0612309,38.01448,48
연천푸르내마을체험관,10,10,127.1067217,38.03476338,20
연천호로고루,54,54,126.8585572,37.98619198,108
연천회관,20,21,127.339943,37.47375322,41
연탄요릿집,5,4,127.0551611,37.53753622,9
연트럴다방,4,4,126.9235633,37.56378305,8
연피랑,3,4,126.9252484,37.56281466,7
연하동,7,7,126.9235575,37.56051243,14
연해장,3,3,127.0218678,37.56483291,6
연현습지공원,3,3,126.8980041,37.42872812,6
연호경의 ‘어른 낙서’ 전시,1,3,126.3175385,33.30566208,4
연화도감,5,5,127.6329218,37.62280564,10
연희김밥 본점,10,10,126.929403,37.56806011,20
연희자연마당,4,4,126.6628067,37.54552624,8
연희장,6,6,126.9300806,37.56608643,12
열두달,9,8,127.2453256,37.9227249,17
열두바구니 송도점,3,4,126.6515216,37.39476233,7
열두시테이블,4,4,126.771114,37.66626598,8
열두알우동집,4,4,127.0150015,37.28002941,8
열린녹지광장,5,5,127.0281653,37.27449642,10
열린송현녹지광장,40,40,126.9817151,37.57656808,80
열린약국,3,3,126.9280872,37.55801952,6
열정냉삼 신중동점,4,4,126.7733616,37.50231511,8
염창역 9호선,5,5,126.8748716,37.54698294,10
영광통닭,4,3,126.9684138,37.58105222,7
영녕릉 세종대왕유적지구 세종대왕릉,22,23,127.6029393,37.30806646,45
영녕릉세종대왕 유적지구,6,6,127.6069783,37.30858822,12
영녕릉세종대왕유적지구 영릉효종왕비인선왕후릉,4,4,127.6088936,37.31348174,8
영동대교북단IC,4,4,127.0596479,37.53394805,8
영동역,4,3,127.7862818,36.1720868,7
영동족발 방이직영점,5,5,127.1080275,37.51400697,10
영등포 이훈헤어샵,4,2,127.7166986,37.88451274,6
영등포공원,8,8,126.9109304,37.51543015,16
영등포돼지갈비,3,3,126.9084214,37.51740323,6
영등포시장역 5호선,16,16,126.9051796,37.52270938,32
영등포아늑,8,8,126.906901,37.51749575,16
영등포역,106,106,126.907876,37.5156837,212
영등포역 1호선,24,22,126.9075503,37.51567263,46
영등포역지하상가,5,5,126.9069572,37.51593526,10
영등포재래시장,6,7,126.9084591,37.51983597,13
영미오리탕 군자점,4,4,127.0762449,37.55767442,8
영빈루,5,5,127.0566337,37.08264619,10
영상식당,3,3,127.2120881,36.45748877,6
영선골순대국,5,5,127.3099216,37.91823833,10
영스피제리아,4,4,127.0135431,37.28357247,8
영심이해물칼국수,1,1,127.4260604,37.07592489,2
영웅이네수산포차 월곶점,5,5,126.7372491,37.38912096,10
영원식당,12,12,126.9310818,37.52615295,24
영월 천문대민박캠핑장,1,1,128.4098963,37.26364756,2
영월공원,8,8,127.648088,37.29460803,16
영월촌놈 여의도본점,4,4,126.9204811,37.52978273,8
영은미술관,3,3,127.2690088,37.41306587,6
영이네,2,2,126.9993347,37.53552004,4
영일분식,4,4,126.889682,37.5162916,8
영종씨사이드 레일바이크,12,12,126.5768667,37.48846151,24
영종씨사이드파크 바다자전거,3,3,127.1292206,35.83450993,6
영천시장,16,17,126.9626683,37.56970342,33
영천휴게소 대구방향,5,4,129.0444974,36.05322303,9
영태리라면,3,3,126.7944605,37.77857441,6
영페이지,4,4,127.0465936,37.26758683,8
영풍문고 강남역점,9,8,127.0274262,37.49915957,17
영풍문고 미아롯데점,5,5,127.0305176,37.6145946,10
영풍문고 사당역점,4,4,126.9822366,37.47769941,8
영풍문고 스타필드코엑스몰점,7,7,127.0591142,37.51150615,14
영풍문고 여의도IFC몰점,4,4,126.9255279,37.52538373,8
영풍문고 종각종로본점,4,4,126.9823416,37.56978188,8
영호돈까스,5,5,126.8985834,37.48170816,10
영화장,5,4,127.0609434,37.59657923,9
예그린씨어터,9,8,127.0030433,37.58388553,17
예래원,5,5,127.1380911,37.90932623,10
예루살렘셀프주유소,4,4,127.2990465,37.929339,8
예림당아트홀,5,5,127.0444339,37.49777406,10
예봉산,5,5,127.2610583,37.55912502,10
예사랑,5,5,127.5006873,37.54883125,10
예술공간 봄,4,4,127.0164552,37.28582199,8
예술공원,4,4,127.0361856,37.25861789,8
예술공원로,5,5,126.9320028,37.41861792,10
예술의전당,19,19,127.0117287,37.47919584,38
예술의전당 IBK챔버홀,4,4,127.0122148,37.47914894,8
예술의전당 한가람미술관,8,7,127.0142365,37.48042814,15
예스24라이브홀,4,4,127.1079715,37.54573487,8
예스24스테이지,5,5,127.0032606,37.58275567,10
예스파크,24,26,127.3856724,37.29308699,50
예스파크 이천도자예술마을,9,9,127.3856689,37.29306177,18
예전한정식,7,6,127.3262239,37.46394614,13
예지현,5,5,127.4945533,37.49115022,10
예크생물원,4,4,127.5516593,37.30113004,8
예하도예 게스트하우스,4,5,126.9851117,37.57442058,9
옐로우성형외과의원,4,4,127.0276319,37.49894779,8
옛고을,4,4,127.3258852,38.06822748,8
옛길 칼국수,5,5,127.3110309,37.9984826,10
옛나루터,4,4,127.3176295,37.54554895,8
옛날농장 방이점,1,1,127.1099895,37.51444305,2
옛날돈까스 2호점,4,4,127.0071077,37.285103,8
옛날돈까스집,2,2,127.0185719,37.28160752,4
옛날맛짜장,4,4,126.777873,37.20616344,8
옛날순두부집,18,20,127.0327196,36.41784022,38
옛날옛적,5,5,127.5093777,37.83317917,10
옛날집,5,5,126.932458,37.48537606,10
옛맛시골집,5,5,127.6752494,37.20564372,10
옛향기가득한 동인동,4,4,127.0203927,37.51807849,8
오가네추어칼국수어죽,2,2,126.743975,37.73829613,4
오가다 대학로본사점,2,3,127.002844,37.58273586,5
오가야,5,5,127.075151,37.55486401,10
오감캠프촌,2,2,127.0247241,37.78156479,4
오거트,4,4,127.0494521,37.54838137,8
오근내2닭갈비,5,5,126.9627811,37.52507698,10
오남역 4호선,9,9,127.1911049,37.70516352,18
오남저수지,5,5,127.2201054,37.69579508,10
오남호수공원,5,5,127.2249394,37.69403807,10
오늘그대와 익선점,3,3,126.9897067,37.57336871,6
오늘손두부,5,5,127.2087238,37.28620046,10
오늘손칼국수&찜,4,4,127.1437823,37.4416593,8
오늘손칼국수&찜 이천점,4,4,127.4413735,37.24786951,8
오늘와인한잔 대학로점,4,4,126.9991532,37.58253407,8
오늘와인한잔 성수가든점,8,8,127.0544503,37.54346873,16
오니리크,5,5,126.9850853,37.2511312,10
오니츠카타이거 가로수길점,4,4,127.0218959,37.52154888,8
오대산국립공원,4,4,128.6021218,37.77720066,8
오뎅&정종,5,5,126.9768967,37.57760878,10
오두산막국수 본점,4,4,126.7589635,37.77137783,8
오두산통일전망대,13,14,126.6772343,37.77327615,27
오들리샷 본점,4,4,126.7565281,37.48999551,8
오디티모드 신라스테이 광화문점,5,5,126.9810912,37.57265046,10
오라델떼,4,4,126.7436942,37.50751992,8
오라방,5,5,127.0237216,37.52109803,10
오라카이 송도파크호텔,25,25,126.6407978,37.38812398,50
오라카이대학로호텔,7,7,126.9987185,37.57557119,14
오라카이대학로호텔 4층 피트니스센터,4,4,126.9987185,37.57557119,8
오라카이대학로호텔 탕초루,4,4,126.9987649,37.57556578,8
오라카이청계산호텔,4,3,127.0546982,37.44898005,7
오랑제뜨22 연남점,4,4,126.9232607,37.56194212,8
오랑주리,4,4,126.9352978,37.77857464,8
오레노라멘 강남점,8,9,127.0280781,37.50050372,17
오레노라멘 송파점,15,15,127.1094304,37.50955652,30
오레노라멘 인사점,14,14,126.9845588,37.57645676,28
오레노라멘 합정본점,13,12,126.9173198,37.5474744,25
오레노카츠 광명점,2,2,126.8795654,37.46112655,4
오렌즈 건대입구점,3,3,127.0705391,37.54028509,6
오렌지루프커피,4,4,127.4899587,37.59224616,8
오롯이꽃,10,10,127.503611,37.671035,20
오류동역 1호선,11,11,126.8448074,37.49439721,22
오리둥지 선물가게,5,5,128.9173635,37.79605196,10
오리랑보리랑,3,4,127.4755907,37.52718145,7
오리마을 본점,5,5,127.1152701,37.76414402,10
오리서원,7,5,126.8804695,37.4285423,12
오리야형곤하우스,4,4,127.6511826,37.625138,8
오리엔스호텔앤레지던스,10,10,126.9911493,37.56002328,20
오리지널 팬케이크하우스 잠실점,1,3,127.1063851,37.51392827,4
오리킹 광릉수목원점,5,5,127.1230278,37.77753171,10
오린지,4,5,127.1063914,37.509653,9
오릴리도넛,4,4,126.7802724,37.67535264,8
오마이게스트하우스,2,2,126.969762,37.58437904,4
오모차랜드 홍대점,5,5,126.9204592,37.55363938,10
오믈렛 먹자,1,1,127.0337277,37.2576545,2
오바케,3,4,126.6421177,37.38411664,7
오복떡집,2,3,127.029646,37.28948755,5
오복솥뚜껑 송도점,5,5,126.6428002,37.38495846,10
오복수산 연남점,4,4,126.9260497,37.562844,8
오브젝트,13,13,126.9663419,37.57154512,26
오븐에빠진닭 명동점,5,5,126.9839727,37.56458517,10
오븐에빠진닭 화곡역점,3,3,126.8381295,37.54122236,6
오블라디풀빌라,9,8,126.7708021,37.84694129,17
오블리펜션,4,4,127.3642533,37.75005817,8
오비스트로,2,3,126.6657312,33.5424616,5
오빈역 경의중앙선,3,3,127.4736614,37.50616717,6
오빌펜션,5,5,127.3059075,37.33903832,10
오빠네옛날떡볶이,4,4,126.7722852,37.65536278,8
오사카부루스 오류점,2,2,126.8429599,37.49536785,4
오산EBS캐릭터공원,9,9,127.0646319,37.14832161,18
오산근린공원,5,5,127.0688506,37.15551689,10
오산농협 하나로마트,4,4,127.0652546,37.16424117,8
오산대역 1호선,14,14,127.0630757,37.16935044,28
오산맑음터공원,8,8,127.0633769,37.13631025,16
오산미니어처빌리지,8,8,127.0626274,37.17734845,16
오산시립미술관,10,10,127.0772411,37.16025219,20
오산에코리움,4,4,127.0636937,37.13823114,8
오산역 1호선,9,9,127.0666301,37.14471716,18
오산오색시장,20,20,127.0708591,37.15093202,40
오산천,5,5,127.0722394,37.15828022,10
오산휴게소 동탄방향,3,3,127.0382856,37.17579909,6
오산휴게소 봉담방향,5,5,127.036526,37.17904614,10
오설록티하우스 북촌점,20,21,126.9845918,37.58099778,41
오설록티하우스 한남점,5,5,127.0010817,37.53851136,10
오설록티하우스 현대미술관점,15,15,126.9806049,37.57938261,30
오성읍구경,5,5,126.4864405,33.51731296,10
오션솔레뷰호텔,29,29,126.5793379,37.49460075,58
오솔커피,4,4,127.2081742,37.72716157,8
오송역,65,65,127.4437687,36.70188576,130
오송역 A주차장,4,5,127.3299186,36.61960181,9
오송하이수산,5,5,127.3324069,36.62972095,10
오술차 사당역점,5,5,126.9811653,37.47594047,10
오술차 영통점,5,5,127.0759397,37.25144658,10
오스스,3,3,127.1946784,37.89259139,6
오스테리아 오르조 한남,5,5,127.0094926,37.53488536,10
오스테리아오라,5,5,126.9143539,37.55635252,10
오스테리아쟌니,5,4,127.0612374,37.54079124,9
오스틴스토리,5,5,127.2152748,37.28588238,10
오슬로우 이천대월점,5,5,127.494743,37.22836915,10
오승렬스시,3,3,126.8615804,37.30238165,6
오시리마트,5,5,127.0462936,37.5172529,10
오시리야주방,5,5,126.8965338,37.57735307,10
오실장 강남면옥 금촌점,5,5,126.7733505,37.75702159,10
오십이도칼국수 본점,3,4,126.6917094,37.34781444,7
오쏘파스타,5,5,127.0057104,37.58054454,10
오아시스,9,10,126.6880512,37.34053267,19
오아시스 방탈출,5,5,126.920103,37.5490873,10
오아시스 한남점,1,1,126.9979634,37.53659762,2
오얏꽃,7,7,126.9905546,37.57299037,14
오오오,5,5,126.706169,37.44359441,10
오오우키친,13,14,127.0179404,37.28140308,27
오오츄,9,9,127.2014743,37.29310415,18
오우,4,4,126.9200853,37.55827566,8
오우도,4,4,127.0497794,37.54535478,8
오우드,7,7,127.0604026,37.54102052,14
오우야 에스프레소바 마곡나루점,9,9,126.8257842,37.56863473,18
오월상점,5,5,126.9253926,37.56351392,10
오월의종 타임스퀘어점,12,12,126.9043906,37.51689548,24
오월의종 한남점,10,10,126.9990632,37.53711301,20
오월호텔AVE,3,3,127.6486524,37.30148875,6
오유알에스(OURS),4,4,126.8140317,37.28577707,8
오이도,46,47,126.6935936,37.3429619,93
오이도 빨강등대,47,48,126.6875106,37.34545535,95
오이도기념공원,5,5,126.690756,37.33480923,10
오이도명물등대빵,8,9,126.6869593,37.34259764,17
오이도명물등대빵 2호점,3,3,126.6915647,37.34786903,6
오이도선사유적공원,9,10,126.6961663,37.34303702,19
오이도역 수인분당선,3,3,126.7389231,37.36292924,6
오이도음식문화거리,4,5,126.6876671,37.34525844,9
오이도전통수산시장,10,10,126.6882097,37.34588158,20
오이도종합어시장,3,3,126.6888536,37.34518408,6
오이도해양단지,4,4,126.6899002,37.34426417,8
오이지,2,4,127.0001811,37.58184572,6
오이지 연남점,5,5,126.92565,37.55966052,10
오잇,3,3,126.9850903,37.54553462,6
오제제,33,34,126.9782579,37.5684225,67
오제제 명동점,3,3,126.9818085,37.56476505,6
오젤헤어,5,5,127.0055915,37.5653754,10
오죽이네,3,4,126.9908035,37.57375803,7
오즈의마법사테마공원,7,9,127.1926313,37.56473364,16
오지아뜰리에,5,5,126.6576742,37.37934404,10
오츠커피,5,5,126.9677521,37.54041348,10
오케이당구장,5,5,126.961664,37.39329096,10
오크우드프리미어 인천,12,13,126.6441992,37.38903167,25
오크우드프리미어 인천 오크레스토랑,3,3,126.6442663,37.38916883,6
오트렉,5,5,126.995408,37.56376085,10
오티주유소,3,3,128.1587123,36.94702046,6
오파에 을지로 하와이,1,1,126.9954509,37.5671459,2
오파토,7,9,126.9878245,37.54349867,16
오팔당,7,7,127.2552127,37.54090795,14
오패산나들길,3,4,127.0334927,37.63165849,7
오포케,4,4,127.0711367,37.54159929,8
오품채,4,4,127.078897,37.79568607,8
오프라벨 영통점,4,4,127.0813276,37.26718422,8
오픈원,4,4,126.9865621,37.57890771,8
오핀베이커리 양주점,14,15,126.9719464,37.71855486,29
오한수 우육면가 스타필드 하남점,5,5,127.2237408,37.54543532,10
오형제손짜장 의정부본점,2,2,127.0723792,37.73563191,4
오후,5,5,127.04334,37.54618624,10
옥구공원,9,9,126.7131891,37.35610114,18
"옥구공원, 옥구공원 반려견놀이터, 조각공원",5,5,126.7131891,37.35610114,10
옥녀봉,5,5,127.0375379,37.43904135,10
옥동식,4,5,126.5985284,37.45409981,9
옥두헌손두부,3,3,127.0294647,37.58712907,6
옥산휴게소 부산방향,3,3,127.3697872,36.65769725,6
옥상,2,2,126.9911206,37.57274534,4
옥상포차,5,5,127.0453153,37.27525698,10
옥소반 마곡나루점,4,4,126.8267344,37.56793696,8
옥소반 마곡본점,5,6,126.832715,37.56054841,11
옥수역 경의중앙선,5,5,127.0187446,37.5405119,10
옥이모깻잎떡볶이,4,3,127.0016392,37.58221322,7
옥정리젠시빌란트아파트,10,10,127.0946194,37.83089023,20
옥정중앙공원,5,5,127.096877,37.82436637,10
옥천 올갱이우렁촌,4,4,126.6573763,37.41352779,8
옥천고읍냉면,5,5,127.4635981,37.51971844,10
옥천냉면황해식당 본점,9,8,127.4578111,37.51974101,17
옥천레포츠공원,4,4,127.4568616,37.52059523,8
옥천순두부,4,4,127.4669481,37.53232908,8
옥천전통냉면 본점,3,4,127.4575322,37.51871289,7
옥천함흥냉면 본점,3,3,127.4615158,37.51993743,6
옥천휴게소 서울방향,5,5,127.5990837,36.29791526,10
옥희,5,5,126.9801761,37.47595112,10
온(잔치집),4,4,128.4220668,38.08124608,8
온기정,14,14,127.5550156,36.95733636,28
온누리교회,5,5,126.9851862,37.51809374,10
온누리쭈꾸미 팔당본점,3,4,127.2355518,37.55894891,7
온달집 본점,4,4,127.0217319,37.51758811,8
온달커피랩,5,5,127.0150959,37.55964963,10
온더레일,4,5,126.7573079,37.88742808,9
온더보더 광화문D타워점,2,3,126.9791039,37.57066252,5
온더보더 롯데월드몰점,2,3,127.1040705,37.51371679,5
온더보더 스타필드하남점,3,3,127.2236193,37.54528328,6
온더스팟 OTS한남점,3,4,127.0000181,37.53600659,7
온더홀,5,5,126.9625889,37.52476788,10
온릉,4,4,126.9514007,37.71951672,8
온블랙94,5,5,126.9223841,37.54827792,10
온새미로,5,5,127.0125848,37.28490972,10
온센 SFC광화문점,3,3,126.9782692,37.5684261,6
온센 강남점,3,4,127.0244549,37.50122893,7
온센 광명점,9,10,126.882622,37.4190189,19
온센 본점,4,3,126.6247703,37.47268641,7
온센 수원점,4,4,127.0339343,37.26588096,8
온소반,5,5,126.6857819,37.70707105,10
온양온천역 1호선,5,5,127.0031815,36.78054488,10
온온사,2,3,126.9924339,37.43636204,5
온유여월,8,8,127.0134196,37.28695679,16
온정리 닭갈비 금강막국수,4,5,127.3713925,37.7722179,9
온정리 닭갈비 금강막국수 본점,5,5,127.3714266,37.77225889,10
온정리금강막국수숯불닭갈비 가평점,6,6,127.4973793,37.83818926,12
온테이블,5,5,126.800159,37.67380229,10
온투,4,4,127.0273428,37.52478235,8
온플리크,3,2,126.9259105,37.5617483,5
온햇반,2,1,127.3533402,37.63495253,3
올댓워터펜션,4,4,127.5121733,37.74732968,8
올댓커피 더현대서울점,9,9,126.9283998,37.52579906,18
올댓커피 본점,4,5,126.7688491,37.65977451,9
올댓커피 에스프레소 바,1,1,126.7564347,37.66606359,2
올더여주 로컬푸드직매장,5,5,127.6539203,37.2999965,10
올더타임 광명소하점,5,5,126.8815798,37.44667184,10
올더타임 역삼점,4,4,127.0399038,37.49382206,8
올데이다이닝 - Food Exchange,5,5,129.067588,35.1526538,10
올드상해,10,10,126.952761,37.54176714,20
올드페리도넛,3,3,127.0030098,37.53959974,6
올드페리도넛 가로수길점,2,3,127.0212553,37.52040473,5
올라메히꼬,4,4,127.0117231,37.283688,8
올라올래,5,5,127.0149621,37.28557981,10
올라이트,3,3,126.9697619,37.57894965,6
올라펜션,4,4,127.4661753,37.81460304,8
올래홀,5,5,127.0035504,37.58160059,10
올리브그릴,5,5,127.0801635,37.39081562,10
올리브영 강남엔터식스점,3,3,127.0044164,37.50502191,6
올리브영 구리수택사거리점,4,4,127.1431358,37.59796237,8
올리브영 대학로점,6,6,126.9985282,37.58304403,12
올리브영 동교동점,4,4,126.9232913,37.55855169,8
올리브영 동탄타임테라스점,2,3,127.0689047,37.20276548,5
올리브영 명동 플래그십,3,2,126.9851726,37.56408617,5
올리브영 미사효성점,3,3,127.1902515,37.56715938,6
올리브영 범계 타운,8,8,126.9535765,37.39055256,16
올리브영 신촌타운점,3,1,126.937093,37.55636682,4
올리브영 종로2가점,5,5,126.9859911,37.56907599,10
올리브영 철산역점,4,4,126.8676476,37.47513172,8
올리브영 파주금촌점,3,4,126.7742977,37.76384551,7
올리브영 하남풍산점,4,4,127.207938,37.55142159,8
올리브영 홍대공항철도역점,3,3,126.9251216,37.55839609,6
올리브영 홍대정문점,5,5,126.9241456,37.55314175,10
올리브영 홍대중앙점,3,3,126.9214657,37.55108573,6
올리브영 회룡역점,3,5,127.0467627,37.72448272,8
올리코,5,5,126.7472995,37.67139979,10
올림선,3,3,127.035793,37.26270874,6
올림픽공원,141,143,127.1208128,37.52053406,284
올림픽공원 88잔디마당,37,37,127.1253167,37.51882828,74
올림픽공원 SK핸드볼경기장,3,3,127.1263142,37.51740003,6
올림픽공원 들꽃마루,10,10,127.1257237,37.51329929,20
올림픽공원 우리금융아트홀,2,2,127.1250145,37.51674548,4
올림픽공원 테니스경기장,5,5,127.1284284,37.51544437,10
올림픽공원역 9호선,4,4,127.1302529,37.51611632,8
올바른김밥,5,5,126.9269604,37.56220305,10
올빛 게스트하우스,10,10,126.9240293,37.5595739,20
올소올소 수원역점,5,5,127.0020067,37.26583715,10
올웨이즈온,5,5,126.9838146,37.4790079,10
올웨이즈옴므,1,1,126.9961849,37.53366392,2
올토갤러리카페도자기공방,5,5,126.9307551,37.41926953,10
올팥,4,4,127.0095649,37.39139112,8
옴 광화문점,3,3,126.9760749,37.57050878,6
옴레스토랑 광교점,4,4,127.0504835,37.29157722,8
옴브레카페,4,4,127.048249,37.73911839,8
옵스 인천롯데점,5,5,126.701572,37.44215749,10
옹기골만찬,17,18,127.32794,37.9698662,35
옹기꽃게장,5,5,126.2686521,33.31892784,10
옹달샘어린이공원,3,3,127.0809397,37.62062543,6
옹심이메밀칼국수&메밀막국수,4,4,127.0745638,37.05805144,8
옹진농협하나로마트 영흥점,4,4,126.4939411,37.26044146,8
와따가포차,5,5,127.038349,37.4836561,10
와룡공원,4,4,126.990122,37.59116878,8
와마트,5,5,126.7467702,37.42618708,10
와마트 화성점,4,4,126.8253868,37.20937866,8
와우리장작구이 백운호수점,4,4,127.0037483,37.37428911,8
와우신내떡 노량진점,9,9,126.9451316,37.51181634,18
와우정사,19,22,127.2767813,37.19417253,41
와우호텔,1,1,127.107782,37.5147298,2
와우힐즈게스트하우스,5,5,126.9266216,37.55216573,10
와이즈파크,5,5,126.9251408,37.55725724,10
와이키키,7,8,126.9883231,37.53910185,15
와이키키 비치펍,5,5,126.9932228,37.53487564,10
와인앤모어 AK광명점,3,4,126.8826497,37.41867654,7
와인앤모어 성수역점,5,5,127.0554581,37.54444224,10
와인앤모어 여의도점,9,9,126.9288826,37.52129885,18
와일드그라스,5,5,127.0948738,36.99710605,10
와플대학 대학로캠퍼스,5,5,127.002879,37.58180514,10
와플대학 모란역캠퍼스,3,3,127.1286886,37.43238543,6
와플대학 충남대캠퍼스,3,3,127.3503126,36.36286322,6
와플대학 홍대캠퍼스,4,4,126.9250129,37.5572932,8
와플샵 용산아이파크몰점,3,4,126.9647427,37.52977,7
와피 미아역점,3,3,127.0274499,37.62545766,6
완강정 압구정본점,5,5,127.0293922,37.52660639,10
완백부대찌개삼겹살 종각그랑서울점,1,1,126.9813904,37.5711116,2
완주혁신도시시외버스승강장,4,4,127.0562834,35.83296468,8
왓쇼이켄,4,4,128.9467287,35.1731997,8
왕김말이랑떡볶이,2,3,126.8842898,37.47966956,5
왕릉일가,10,10,126.8979037,37.62532839,20
왕방계곡,5,5,127.1152521,37.89567628,10
왕비집,4,4,126.9864498,37.56159777,8
왕세숫대야냉면돈까스,5,4,126.8543458,37.55549185,9
왕손이네,3,3,127.0782399,37.61906764,6
왕송호수,20,20,126.9476694,37.30765541,40
왕숙천,4,4,127.1510455,37.64277481,8
왕십리역 2호선,4,4,127.0371034,37.56126836,8
왕십리역 경의중앙선,13,13,127.0383329,37.56205814,26
왕십리역 수인분당선,5,5,127.0387838,37.56063983,10
왕장군주먹고기 신월점본점,4,4,126.8325623,37.53926844,8
외할머니집,2,2,127.318977,37.2422219,4
요거트아이스크림의정석,4,4,127.0433542,37.54727914,8
요거프레소 대부도점,5,5,126.5720119,37.2857477,10
요거프레소 양평국수점,4,3,127.4008229,37.51167159,7
요그앤오트,5,4,127.0578194,37.50596381,9
요로시 의정부점,3,4,127.0476398,37.74092238,7
요로코부,5,5,126.6423636,37.39343662,10
요미우돈교자,11,11,127.0122599,37.28393302,22
요비,5,5,127.0689014,37.54228267,10
요찌무,4,4,127.108681,37.50987977,8
욕쟁이할머니집,4,4,127.1661767,37.79626921,8
욜로,5,5,127.1298696,37.4319084,10
용담민물장어 본점,5,5,127.3239553,37.54168542,10
용두삼겹살쭈꾸미,2,2,127.0891871,37.55329732,4
용리단길,3,4,126.9722045,37.53145146,7
용문5일장,5,5,127.5942425,37.48401627,10
용문감성펜션,4,5,127.6022286,37.51603317,9
용문농협하나로마트 단월점,2,2,127.6734124,37.54172328,4
용문농협하나로마트 본점,14,14,127.5937578,37.48506386,28
용문막국수,5,4,127.5931772,37.4825548,9
용문사,56,57,127.5711691,37.55030611,113
용문산,8,10,127.5485971,37.5621503,18
용문산 백운봉 등산로,4,4,128.2597119,36.43992435,8
용문산관광지,18,18,127.5810914,37.54652041,36
용문산보리밥,5,5,127.5851011,37.54991354,10
용문산빵공장,10,11,127.6010385,37.51770426,21
용문산야영장,4,4,127.5798175,37.5472817,8
용문산자연휴양림,10,11,127.5190793,37.51630533,21
용문산중앙식당,12,13,127.5833027,37.54566978,25
용문역,7,7,127.5943851,37.48261,14
용문역 경의중앙선,3,3,127.5937953,37.48180207,6
용문천년시장,7,8,127.5942562,37.48403062,15
용문휴게소,4,4,127.5934933,37.49450762,8
용봉산,5,5,126.6491973,36.64365289,10
용비쉼터,4,4,127.030406,37.54630651,8
용산 국립중앙박물관,4,4,126.4558066,33.49335141,8
용산가족공원,39,38,126.9829983,37.52185093,77
용산공원 부분개방부지,30,32,126.9882023,37.520573,62
용산구청,3,3,126.9905756,37.53242563,6
용산기지 미군장교숙소 부지 입구,4,4,126.988145,37.52051417,8
용산마루,4,4,126.962627,37.52547337,8
용산역,356,360,126.9648241,37.53007636,716
용산역 1호선,10,10,126.9646296,37.52977357,20
용산역 경의중앙선,26,27,126.9647575,37.52960692,53
용산역광장,5,5,126.9655033,37.52905303,10
용산역사박물관,14,14,126.9658024,37.52566174,28
용산전자랜드신관,3,2,126.959288,37.53287129,5
용산전자상가 제2공영주차장,5,5,126.9630726,37.5326617,10
용산푸르지오파크타운2단지아파트 207동,12,13,126.9955745,37.52506925,25
용설호수캠핑장,12,12,127.4423762,37.05048665,24
용성통닭,40,41,127.0176265,37.27962538,81
용소폭포,10,10,127.4410871,38.01550205,20
용소폭포 세븐일레븐 편의점,5,5,127.4719618,37.9598118,10
용수양봉박물관&용수양봉카페,4,4,127.1046478,37.44917254,8
용암리 계곡,5,5,127.0259443,37.8405701,10
용암천,8,9,127.1344462,37.65775118,17
용양봉저정공원,5,4,129.2132068,35.19604352,9
용연,27,28,127.0183862,37.28788599,55
용용선생 방이점,4,4,127.108971,37.51411242,8
용용선생 송도점,5,5,126.643456,37.38452164,10
용용선생 영등포역점,5,5,126.9075391,37.51741516,10
용용선생 홍대점,5,5,126.9220283,37.55088878,10
용이네정육점식당,3,3,127.3240766,37.33813577,6
용인669프라이빗파크 카라반캠핑카주차장,3,3,127.140757,37.28498979,6
용인곤충테마파크,5,5,127.3659655,37.14617848,10
용인공용버스터미널 (2024년6월예정),3,5,127.2098772,37.23290003,8
용인농촌테마파크,5,7,127.2983292,37.17222468,12
용인대장금테마파크,5,5,127.3375794,37.12119169,10
용인보정동 고분군,3,3,127.0971741,37.2958992,6
용인스파랜드,4,3,127.1571111,37.23482713,7
용인시박물관,4,5,127.1572147,37.27387098,9
용인시장불타짬뽕,2,3,127.2022805,37.23699408,5
용인어린이상상의숲,7,7,127.1658031,37.24980325,14
용인에버스트리트,5,5,127.2229229,37.30047942,10
용인우렁각시,4,4,127.1713073,37.2414896,8
용인자연휴양림,9,9,127.2678463,37.31487489,18
용인조정경기장,2,2,127.1001324,37.24054398,4
용인휴게소 강릉방향,7,6,127.2423181,37.24555363,13
용인휴게소 서창방향,3,3,127.2383821,37.24833322,6
용주사,5,5,127.0050787,37.21217075,10
용추계곡,9,9,127.621509,36.77417434,18
용추골미궁순대 서수원점,5,5,126.9750251,37.28264434,10
용추폭포,5,5,127.4812215,37.8551365,10
용호낙지 강남점,4,4,127.0521791,37.50586913,8
용화반점,5,5,126.6353887,37.47200966,10
우가현,5,5,127.4663648,37.48514166,10
우기식당 육지점,5,5,127.0233807,37.50901023,10
우나기강,5,5,127.1019512,37.41577873,10
우나유,4,4,127.0266575,37.48738538,8
우동가조쿠,3,3,127.0428844,37.55680106,6
우동가조쿠 홍대점,3,3,126.9240894,37.55832696,6
우둠지제빵소,9,9,127.31509,38.06160635,18
우드앤브릭 재동점,8,8,126.984214,37.57954532,16
우드페커,6,6,127.3025001,37.3307342,12
우래옥,5,5,126.9987092,37.5681851,10
우래옥 본점,45,48,126.9987187,37.56821186,93
우렁쌈밥마당,4,5,127.5251197,37.80335713,9
우리농산물유통센터,5,5,127.0364238,37.52778384,10
우리돈까스,4,4,127.4193116,37.73778784,8
우리동네 온정복지관,5,5,127.0303339,37.55280453,10
우리동네감자탕,1,1,126.7473452,37.67697603,2
우리바다수산,4,4,126.9049355,36.92643448,8
우리분식,1,1,126.9504601,35.94151878,2
우리불가마사우나,4,4,126.9146024,37.5051434,8
우리유황온천,5,4,127.0839017,37.53075638,9
우리집갈비,3,3,126.7734772,37.76421424,6
우리콩 순두부,5,5,127.0099282,37.66248007,10
우리홈마트,3,3,127.3670992,38.03671083,6
우마이도 건대점,5,5,127.0716902,37.54304146,10
우면산둘레길,5,5,127.0179801,37.47632984,10
우미관,1,2,127.1148109,37.5635069,3
우미노미,5,5,126.8994451,37.53044605,10
우미마토,5,5,126.8320097,37.5596338,10
우미정,2,1,127.4449964,37.27973457,3
우미회전초밥 신당점,3,3,127.0158328,37.56551142,6
우산각어린이공원,4,4,127.0243879,37.57341349,8
우성메디피아,4,4,127.1072637,37.16700477,8
우성아파트 정문,4,4,126.8681246,37.48808155,8
우스블랑 본점,5,5,126.9623882,37.54138497,10
우시야 성수점,4,5,127.0568036,37.53859682,9
우영관,5,5,127.1120316,37.39425685,10
우영우김밥 촬영지,1,3,127.0115424,37.2837222,4
우와,9,9,126.8223628,37.52840523,18
우월소곱창,5,5,126.885395,37.50739461,10
우육면관 광화문점,4,4,126.9812317,37.5720414,8
우육면관 청계천점,10,10,126.9861112,37.56855523,20
우육미,5,5,127.0130076,37.56521984,10
우이교,5,5,127.0309098,37.64287826,10
우이동 만남의광장,5,5,127.0076977,37.66186036,10
우이락,5,5,126.9059834,37.55643265,10
우장산공원산책길,5,5,126.8435458,37.55272639,10
우전옥간장게장,4,5,126.9993141,37.31269115,9
우정갈비,5,5,126.9059066,37.51851309,10
우정약국,3,3,126.9998777,37.57057608,6
우정옥,5,5,127.647867,37.30249949,10
우정총국시민광장,2,4,126.9823903,37.57440579,6
우주가챠,4,4,127.0258898,37.50374423,8
우주라이크카페 가평점,5,5,127.5095621,37.83291529,10
우주라이크커피,3,4,127.0516841,37.08107338,7
우지커피 대학로점,4,4,127.00192,37.57882557,8
우지커피 인천계양점,4,4,126.7335629,37.53226511,8
우콘카레,3,4,127.0560454,37.5399685,7
우쿠야,4,4,127.0257711,37.50079257,8
우쿠야 가평마루산점,5,5,127.5092185,37.85034105,10
운길산,13,13,127.2945477,37.57260527,26
운길산역 경의중앙선,26,26,127.3102316,37.55464254,52
운길산자전거,4,4,127.3096139,37.55415763,8
운길산콩마을,4,4,127.3090206,37.55461959,8
운동장.송담대역 에버라인,8,8,127.2090526,37.2379113,16
운동창고 신내점,5,5,127.0968458,37.60178278,10
운멜로 1호점,11,13,127.0114797,37.28475845,24
운멜로랩 2호점,9,9,127.0096573,37.28462166,18
운멜로키친,3,3,127.016515,37.28608599,6
운악막국수숯불닭갈비 본점,3,3,127.3563888,37.85285962,6
운악망경 제6경,4,3,127.3248989,37.878003,7
운악산(현등산),4,4,127.3228774,37.87869451,8
운악채한옥마을,5,5,127.3453763,37.86261816,10
운정신도시푸르지오파르세나아파트,5,5,126.7350749,37.73637272,10
운정호수공원,8,10,126.7578737,37.71988717,18
운주사,4,3,127.3029771,37.88543782,7
운천칼국수,5,5,127.2745686,38.08955979,10
운현궁,44,47,126.9870856,37.57622641,91
울룰루펍,5,5,126.7513742,37.66295186,10
울미숲카페,3,4,127.2347097,37.86098525,7
울산공항,14,14,129.3558969,35.59285141,28
울산역,63,62,129.13866,35.55154319,125
울트라커피&카페드림,5,5,127.0385356,37.62145598,10
웃사브,4,4,126.922504,37.54906007,8
웅진플레이도시,17,17,126.7441352,37.49993804,34
웅파이 공릉숲길점,5,5,127.0775423,37.62359195,10
워낭소리 수원점,4,5,127.0298182,37.25716177,9
워시랜드,4,4,126.8274893,37.20574871,8
워킹온더클라우드,4,4,126.9402253,37.51991579,8
워터캐슬 하남미사점,5,5,127.1976983,37.56673719,10
워터플레이 수상레저,13,13,127.52018,37.79522363,26
원가회관 평택AK플라자점,5,5,127.0853844,36.99106158,10
원골드,5,5,126.9904365,37.5755636,10
원광대간이터미널,5,5,126.954484,35.964798,10
원당감자탕 마포본점,1,1,126.9495909,37.54116306,2
원당감자탕 역삼역점,3,3,127.0339635,37.50084095,6
원당감자탕 영등포점,8,8,126.9093984,37.5176887,16
원당성사화훼단지,4,3,126.8466009,37.6654657,7
원당쇠고기국밥,7,7,126.8534776,37.64740075,14
원당시장,12,12,126.8371306,37.65647113,24
원당역 3호선,8,8,126.8429184,37.65311021,16
원더마마,5,5,126.904688,37.556965,10
원더플레이스 롯데월드몰5층점,4,4,127.1038489,37.51374943,8
원두막,5,5,126.8581522,37.82734081,10
원두막주말농장,3,3,126.9533392,37.66689327,6
원마운트,18,18,126.8341564,37.29363835,36
원마운트 워터파크,3,3,126.7543044,37.66452571,6
원모어백,6,8,126.9693757,37.57664841,14
원미종합시장,5,5,126.7905967,37.49429914,10
원보만두,4,4,126.6189692,37.47525553,8
원뼈감자탕,4,4,126.8794554,37.41840032,8
원삼메밀집,2,3,127.3320289,37.18380366,5
원아베뉴(01AVENUE),4,4,127.0303905,37.49988866,8
원인재역 수인분당선,3,3,126.6864578,37.41321205,6
원적산,5,5,126.6885196,37.50878658,10
원조 옹심이메밀칼국수 본점,8,8,126.9347593,37.39764373,16
원조1호 장충동할머니집,5,5,127.0058944,37.56025051,10
원조광릉찐빵만두,3,3,127.1699479,37.76329221,6
원조광명할머니빈대떡,4,4,126.8558021,37.48096451,8
원조남산왕돈까스,8,8,126.9861065,37.55738107,16
원조누드치즈김밥,10,10,126.9981096,37.56977237,20
원조만선호프 노가리체인본점,8,8,126.9917823,37.56724931,16
원조만선호프2,5,5,126.9918163,37.56693397,10
원조양평해장국,10,10,127.4962632,37.49544802,20
원조왕순대,5,5,126.9912248,37.57241018,10
원조우렁쌈밥순두부,5,5,127.2806183,37.84621374,10
원조원할매소문난닭한마리,3,3,127.0052976,37.57029124,6
원조유박사곱창 구리본점,5,5,127.1412925,37.59986388,10
원조이동김미자할머니갈비,9,9,127.3661386,38.03412008,18
원조이모네곱창,7,8,127.1411067,37.59981364,15
원조초계탕,9,9,127.0470387,37.9041138,18
원조최미자소머리국밥 본관,8,8,127.3354711,37.34609792,16
원조파주골순두부,5,5,127.2788492,38.02776746,10
원조포항물회,4,4,127.0765115,37.19708418,8
원조할머니손두부,1,2,126.734729,37.83860564,3
원조향토이동갈비,5,5,127.3263561,37.96582002,10
원주골추어탕,5,5,126.8931004,37.6445025,10
원주휴게소 춘천방향,2,2,127.9318344,37.43445151,4
원천유원지 광교본점,3,3,127.0640788,37.286332,6
원천호수,12,12,127.0632034,37.2792494,24
원터,5,5,127.025184,37.39582096,10
원평시골장터,5,5,127.1030098,37.22824673,10
원효대교북단교차로,1,3,126.951162,37.52989491,4
원흥주유소 원흥동지점,3,3,126.8660108,37.63999065,6
월계역 1호선,4,4,127.0588571,37.63327755,8
월곡역,4,4,126.249829,33.21773282,8
월곶미래탑광장,3,3,126.7401511,37.3878254,6
월곶역 수인분당선,8,8,126.7427076,37.3918207,16
월곶포구,11,11,126.7384936,37.38778931,22
월드빌라,5,1,126.8437472,37.54678818,6
월드컵공원,5,5,126.8976354,37.56319399,10
월드타워약국,3,3,127.104288,37.51396528,6
월드포토,5,5,126.9904699,37.56266134,10
월량관,5,5,126.925303,37.56254079,10
월미공원,48,50,126.6035403,37.47347124,98
월미공원 공영주차장,5,5,126.6013558,37.47523346,10
월미공원 전망대,5,5,126.6052929,37.4695271,10
월미공원 전망테크,4,4,126.6025553,37.47246962,8
월미공원 제2주차장,5,5,126.5990709,37.46955661,10
월미관,3,4,126.598056,37.47625844,7
월미도,87,87,126.5975258,37.2703531,174
월미도 놀이공원,5,5,126.596287,37.471318,10
월미도공영주차장,5,5,126.601701,37.47496432,10
월미도관광호텔,4,5,126.5968081,37.47243212,9
월미도등대길,4,3,126.5948444,37.46889347,7
월미도레미,10,10,126.5978761,37.47524239,20
월미도선착장,20,20,126.5976045,37.4757181,40
월미도해월관광호텔,9,9,126.5980402,37.47351663,18
월미문화관,4,4,126.6039045,37.47643496,8
월미문화의거리,18,20,126.5978418,37.47362137,38
월미문화의거리역,7,7,126.5992191,37.47735711,14
월미바다역,49,53,126.794056,37.49967985,102
월미바다열차 탑승 관광,5,5,126.5972239,37.4705834,10
월미산,9,9,126.6039608,37.47176434,18
월미양궁연습장,3,3,126.5982708,37.4749104,6
월미전통정원,14,14,126.6057526,37.47411655,28
월미테마파크,82,85,126.5963341,37.47145021,167
월미테마파크 바이킹,3,4,126.5965008,37.47156251,7
월미테마파크 학무대,3,3,126.5956853,37.47185525,6
월송유로베이커리앤로스터리,10,9,127.551083,37.84783896,19
월암근린공원,3,4,126.3191925,33.23922235,7
월영당 서울,7,7,126.9816361,37.57993959,14
월정교,5,5,129.2181213,35.82929955,10
월하여관,43,42,126.9909277,37.57642228,85
웨딩가구의거리,4,4,126.6332384,37.47205346,8
웨딩그룹위더스 영등포,7,8,126.904593,37.52137723,15
웨딩스퀘어 강변점,3,3,127.0956787,37.53572996,6
웨딩시티 신도림점,2,2,126.8901683,37.5070928,4
웨스턴돔 A동,7,7,126.7721839,37.65588516,14
웨스트레이븐호텔,2,1,126.6929205,37.34750493,3
웨스트빙고,5,5,126.990939,37.52073065,10
웨스트힐호텔,5,5,126.6847288,37.78321061,10
웨스티조선 서울호텔,4,4,127.0669254,37.28422019,8
웨스틴서울 아트갤러리,3,3,127.7235629,37.89458007,6
웨스틴조선 서울,24,24,126.9800564,37.56446924,48
웨스틴조선 서울 수영장,5,5,127.7223583,37.87786892,10
웨스틴조선 서울지점,40,39,126.9800564,37.56446924,79
웨스틴조선 환구단,3,3,126.9409853,37.58990008,6
웨스틴조선서울,4,4,127.7166986,37.88451274,8
웨스틴조선서울 라운지,3,4,127.0371034,37.56126836,7
웨스틴조선서울 라운지앤바,4,4,126.9801832,37.56448368,8
웨스틴조선서울 아리아,34,34,127.0865456,37.60934514,68
웨이브서프,10,10,127.3694187,37.65277692,20
웨이브파크,15,16,126.6806862,37.32409989,31
웬디의하루,5,5,127.2015728,37.02187144,10
웰빙논두렁우렁쌈밥전문점 오야동직영점,4,4,127.1059447,37.45360707,8
위곡골,3,3,127.5041245,37.64841118,6
위드멍애견동반펜션,6,6,127.3539904,37.7446332,12
위드위드,4,4,127.0117788,37.64007065,8
위드유상점,5,5,126.724748,37.49477675,10
위례 스토리박스,4,4,127.1420455,37.46318839,8
위례성길,3,4,127.1180768,37.51576872,7
위례스타힐스아파트 2507동,4,3,127.1469609,37.47971501,7
위례중앙광장,5,5,127.1418538,37.47300333,10
위베이크,5,7,127.2424748,37.45997959,12
위스터디카페 신논현점,3,3,127.0226413,37.50255557,6
위스테리아,3,3,127.1845357,37.47820177,6
위시티일산자이4단지아파트,5,5,126.8149058,37.67990435,10
위코스테이 명동,14,14,126.9975586,37.56287746,28
위크레페,8,8,126.964736,37.52976279,16
위키드와이프 페어링바,1,1,127.0478404,37.54085869,2
위해브투데이,12,13,127.0135431,37.28358148,25
윈야드 성수,1,3,127.0504222,37.54384894,4
윌로우그린,3,4,126.7357455,37.39024839,7
유가,5,5,126.9814664,37.55660197,10
유가네닭갈비 수원역점,4,4,127.0034544,37.26812576,8
유가네닭갈비 영등포2호점,5,5,126.9078198,37.51721536,10
유가네닭갈비 철산역점,3,4,126.8701199,37.47589943,7
유가네칼국수,10,10,126.5689066,37.27620351,20
유나이티드갤러리,5,5,127.0280385,37.50358517,10
유니버설아트센터,5,5,127.0879756,37.55090878,10
유니클로 광화문D타워점,2,1,126.9790768,37.5705526,3
유니클로 신사점,4,5,127.0244424,37.51847056,9
유니클로 신세계백화점의정부점,5,5,127.0461833,37.73774614,10
유니클로 아이파크몰용산점,5,5,126.9645305,37.52881487,10
유니클로 포천점,4,4,127.1330229,37.81008517,8
유니티레코드바,5,5,126.919289,37.55150863,10
유니플렉스,14,15,127.0037043,37.58117171,29
유람선회집,3,3,126.5978975,37.47504154,6
유러그미,5,5,127.0203017,37.59124133,10
유리섬박물관,13,14,126.6024858,37.21973129,27
유림공원,3,3,127.3574414,36.35997097,6
유림면,4,4,126.976095,37.56423785,8
유메르 서울스토어,5,5,127.037096,37.5236246,10
유명골프클럽,5,5,127.107923,37.41774486,10
유명산,13,13,127.4865726,37.57528381,26
유명산계곡,9,9,127.4989874,37.58035859,18
유명산밸리캠핑장,12,12,127.493539,37.6021853,24
유명숯불닭갈비,9,9,127.4898374,37.67178856,18
유방녕 더현대서울점,4,4,126.9285707,37.52572799,8
유성고속버스터미널,10,10,127.3364322,36.35987066,20
유성금호고속터미널 앞 주차장,5,5,127.3366163,36.35943307,10
유성시외버스정류소,21,21,127.3304217,36.35630796,42
유스퀘어광주종합버스터미널,58,57,126.8793103,35.1604031,115
유스트레스,5,5,127.0554797,37.54302676,10
유스페이스몰1 A동,3,3,127.1069899,37.40025511,6
유아트스페이스,5,5,127.0458316,37.52739854,10
유아히어 명동본점,4,4,126.9844933,37.56489158,8
유어홈커피로스터스,4,4,126.8936777,37.51276333,8
유운커피,5,5,127.2245803,37.29798943,10
유원생태가,4,4,127.3895039,36.35325433,8
유원호텔,10,10,127.0128535,37.48521446,20
유유샤브 구월점,4,4,126.7037103,37.44494339,8
유일닭강정,13,14,127.5135261,37.83054841,27
유일설렁탕 일산점,4,5,126.7767005,37.69463583,9
유적지방문자센터,4,4,127.0605415,38.0154011,8
유정상스시,5,5,126.9025516,37.51845442,10
유즈라멘 만리동점,10,8,126.9682384,37.55681539,18
유즈풀아뜰리에,4,3,127.0404662,37.54698644,7
유진막국수,3,3,126.992393,37.52843793,6
유진민속박물관,5,5,126.8657589,37.64588009,10
유진식당,4,4,126.9883179,37.57204232,8
유천옥,5,5,126.6692389,33.54306157,10
유치회관,16,17,127.0555879,37.29721169,33
유키사키,3,3,126.9741742,37.55121714,6
유포리아커피로스터스,3,3,127.0009617,37.53576872,6
유플래닛 어반브릭스,4,4,126.88276,37.41818019,8
유피피컬러스튜디오,3,5,126.9115933,35.151311,8
유핑 성수점,5,5,127.0559972,37.54199397,10
육개옥,5,5,127.0322563,37.50723857,10
육남매별빛촌,5,5,127.1647842,37.76845306,10
육림호,5,4,127.1649526,37.74818831,9
육백마지기,10,10,128.5125708,37.40697857,20
육수당 수서역사점,3,3,127.1046079,37.48541302,6
육수당 이대역점,4,4,126.945667,37.55645758,8
육시리 구월점,3,3,126.7026534,37.44475333,6
육쌈냉면 홍대1호점,3,4,126.9215929,37.55174444,7
육육걸즈 스타필드 고양점,3,3,126.8946922,37.64705552,6
육의전PC방,3,3,126.9891875,37.57055396,6
육장,10,10,126.9069548,37.55434671,20
육첩반상 현대프리미엄아울렛 다산점,5,4,127.15207,37.61618361,9
육콩이네 연잎밥연잎돌솥밥,2,3,127.3239007,37.54161709,5
육합춘,5,5,126.9041471,37.44187728,10
육회독존,5,5,127.0743758,37.252615,10
육회왕자연어공주 마곡발산점,5,5,126.8377166,37.55895883,10
육회자매집 본점1호점,9,9,126.9998868,37.57055085,18
"육회한 달,밤",5,5,126.9170278,37.54962578,10
윤가네장원추어탕,3,3,127.4530064,37.27309151,6
윤동주문학관,12,14,126.9671183,37.59213047,26
윤동주시인의언덕,3,3,126.9662696,37.59105805,6
윤쉐프정직한제빵소,13,13,127.0853045,37.78425741,26
윤희 쉐어하우스,5,5,126.9807794,37.4775733,10
율곡로,5,4,126.9981589,37.574971,9
율곡수목원,38,40,126.8270816,37.8963751,78
율곡습지공원,7,8,126.8134816,37.89006394,15
율곡이룸주유소,4,4,128.1864474,36.11293098,8
율동공원,18,18,127.1519514,37.37912917,36
율동공원 분당저수지,5,5,127.1495072,37.37643823,10
"율동공원, 책테마파크",5,5,129.3367672,35.54027447,10
율동칼국수,4,5,127.1491516,37.38387212,9
율봄식물원,5,5,127.2706762,37.47082417,10
율이랑,7,8,127.2983245,37.51451756,15
융가비빵,2,2,127.0094415,37.4347238,4
융건릉 융릉건릉역사문화관,5,5,126.9889938,37.20825439,10
으뜸50안경 인천송도점,3,3,126.6422571,37.38329533,6
으뜸50안경 평택점,5,5,127.0885873,36.99324076,10
으뜸착한낙지,3,4,126.7918248,37.84892278,7
으뜸플러스안경 인천송도점,2,3,126.6511604,37.39570733,5
은나무,4,4,126.9822248,37.57885533,8
은사시힐링캠핑장,2,2,126.8446185,37.95649405,4
은성손두부,5,5,127.5262669,37.22772869,10
은성약국,3,3,126.9880675,37.57335054,6
은성횟집,3,3,127.0001494,37.57040309,6
은식당,4,5,127.0002491,37.58174661,9
은영아파트,19,19,126.6684978,37.51961887,38
은이성지,4,4,127.2778168,37.21550693,8
은주정,4,4,126.9997566,37.56867047,8
은주주식회사,5,5,127.0014206,37.26828078,10
은평역사한옥박물관,3,3,126.9379784,37.64040452,6
은평한옥마을,18,19,126.9390924,37.64148628,37
은행골 서현점,2,2,127.1217455,37.38421707,4
은행나무식당,4,4,127.5837263,37.54542983,8
은행나무집,4,4,127.1345559,37.44305412,8
은행나무집손칼국수,4,4,126.7703649,37.46008813,8
을밀대 무교점,4,4,126.9803682,37.5670966,8
을밀대 본점,5,5,126.9455287,37.54748717,10
을밀대 일산점,5,5,126.7509146,37.66956227,10
을왕리해수욕장,15,15,126.372737,37.446292,30
을왕리해수욕장 (삼양민박),4,4,126.3733555,37.4470053,8
을지 장만옥,5,5,126.9910581,37.56573559,10
을지1막,5,5,126.9914882,37.56533017,10
을지다락,13,13,126.9914205,37.56374441,26
을지다락 도산공원,5,5,127.035699,37.52619109,10
을지대학교 성남캠퍼스,3,3,127.1651358,37.46099596,6
을지로 포장마차촌 선이네,4,4,128.8982831,37.8142111,8
을지로3가역 3호선,3,3,126.9926155,37.56643127,6
을지로4가역 2호선,5,5,126.9976321,37.5666405,10
을지로가구거리,5,5,126.9982161,37.56591251,10
을지로골목집,5,5,126.9704264,37.5304401,10
을지로노가리골목,4,4,126.9917914,37.56719526,8
을지로도화지,4,4,126.9887715,37.56662558,8
을지로떡볶이호프,2,2,126.9915577,37.566733,4
을지로만선호프,13,12,126.9907501,37.56669783,25
을지로미팅룸,5,5,126.9910581,37.56537519,10
을지로입구역 2호선,5,5,126.9821953,37.56603552,10
을지로코업레지던스,7,7,127.0054014,37.56617909,14
을지루이스,5,5,126.9904506,37.56296948,10
을지맥옥,5,5,126.990723,37.56546517,10
음성휴게소 하남방향,4,4,127.4844875,37.02192049,8
음식이야기밥,5,5,126.9839568,37.57534305,10
응봉산,5,5,127.0298342,37.54825281,10
응봉산 팔각정,5,5,127.0299087,37.54782031,10
의성휴게소 청주방향,4,4,128.4446403,36.41098072,8
의왕시청 전기차충전소,4,4,126.9699789,37.34514613,8
의왕역 1호선,4,4,126.9479765,37.32034211,8
의왕조류생태과학관,11,10,126.9503609,37.31091472,21
의왕휴게소 서울방향,14,12,126.9850822,37.34706189,26
의정부 신세계백화점,5,5,126.9019026,36.30714415,10
의정부미술도서관,10,10,127.1061274,37.74514581,20
의정부버스터미널,3,3,127.0550698,37.74521676,6
의정부부대찌개,5,5,127.0308067,37.61250243,10
의정부부대찌개거리,9,9,127.0495734,37.74472547,18
의정부역 1호선,9,9,127.0459568,37.73836249,18
의정부역 행복로,4,4,127.0482401,37.73936346,8
의정부음악도서관,13,15,127.0537733,37.72855753,28
의정부제일시장,15,15,127.0504005,37.73976619,30
의정부휴게소,4,4,127.1148802,37.7328809,8
의정부휴게소 구리방향,6,6,127.1149495,37.73296004,12
이가원항아리수제비,4,4,126.7286429,37.37011429,8
이곡둑길153,13,13,127.5488885,37.88132814,26
이공커피 연희점,5,5,126.9298951,37.56599622,10
이기석커피치즈케익가게,5,5,126.890216,37.48843301,10
이나경송탄부대찌개,37,38,127.0359994,37.26293664,75
이나집초밥,3,3,127.1697404,37.00242549,6
이남장 삼성점,5,5,127.0644501,37.51356846,10
이너프유,5,5,127.0407453,37.77629871,10
이누네코식당,2,3,126.8900082,37.66219855,5
이니스프리 잠실지하점,5,5,127.1010864,37.51349323,10
이담,3,4,127.4471643,37.28137529,7
이대목동병원,1,1,126.8862849,37.53660416,2
이도곰탕 을지로 직영점,4,4,126.9811026,37.56766435,8
이도옥설렁탕,3,4,126.749667,37.67656563,7
이동강변갈비,8,8,127.3730588,38.0438742,16
이두형홍두깨칼국수,4,4,126.9834952,37.20344754,8
이디야 안성아양지구점,4,4,127.2584521,37.00822341,8
이디야 하남검단산점,3,3,127.228445,37.53547929,6
이디야커피 가평역점,8,8,127.5117436,37.8135697,16
이디야커피 가평점,5,4,127.5142783,37.82893784,9
이디야커피 갈매로데오점,5,5,127.1169841,37.63299998,10
이디야커피 경희대캠퍼스점,3,3,127.051108,37.59529728,6
이디야커피 광화문점,6,6,126.9756534,37.571507,12
이디야커피 구리교문동점,5,5,127.1348751,37.60042279,10
이디야커피 구리롯데아울렛점,4,4,127.1400237,37.61168637,8
이디야커피 금란망우점,4,4,127.1031353,37.60010521,8
이디야커피 김포라베니체점,4,4,126.6783495,37.64247988,8
이디야커피 남양주팔당한강점,5,5,127.2478132,37.54449166,10
이디야커피 남양주호평점,4,4,127.2439827,37.65507438,8
이디야커피 노량진드림스퀘어점,5,5,126.9377777,37.51406521,10
이디야커피 대부도펜션타운점,4,4,126.6243826,37.23322198,8
이디야커피 독립문역점,4,4,126.9568228,37.57575791,8
이디야커피 부천송내점,5,5,126.7528507,37.49006717,10
이디야커피 성수중앙점,3,4,127.055243,37.54429728,7
이디야커피 수원인계한신점,3,3,127.0292997,37.27487819,6
이디야커피 시흥배곧신도시점,5,5,126.7280343,37.36951641,10
이디야커피 안양예술공원점,3,3,126.9223193,37.4185651,6
이디야커피 영등포역코레일점,4,3,126.9076657,37.51566821,7
이디야커피 오이도빨간등대점,4,4,126.6872579,37.34351477,8
이디야커피 오장동점,4,3,127.0001302,37.56459256,7
이디야커피 용인양지점,5,5,127.2857863,37.23452705,10
이디야커피 용인에버랜드역점,5,5,127.2168682,37.28706884,10
이디야커피 의정부낙양점,4,4,127.1125333,37.75554424,8
이디야커피 인천월미도점,2,2,126.5983416,37.47550797,4
이디야커피 종로3가점,5,5,126.9915375,37.57010365,10
이디야커피 종로교차로점,1,2,127.0022549,37.57060128,3
이디야커피 진접센트레빌점,3,3,127.1998833,37.74021294,6
이디야커피 청평점,1,1,127.4205727,37.73850772,2
이디야커피 충무아트홀점,3,3,127.0140172,37.56528099,6
이디야커피 하계온천점,4,4,127.0727307,37.64026506,8
이디야커피 하남덕풍점,3,3,127.2035482,37.53852335,6
이뜨랜리조트,4,4,127.5394652,37.75552196,8
이뜨랜수상레저,4,3,127.5390093,37.75587903,7
이라운지 서울대점,3,3,126.9510644,37.4488195,6
이랜드크루즈,15,17,126.9384582,37.5256831,32
이룸웨딩컨벤션,3,3,126.9497251,37.54184698,6
이룸채오피스텔,4,4,126.9164205,37.63634399,8
이리데한복,4,4,127.1125664,37.25627946,8
이리로,3,3,127.1299032,37.48662861,6
이마트 가양점,3,3,126.86191,37.55814987,6
이마트 강릉점,5,5,128.9226349,37.77044897,10
이마트 검단점,5,5,126.6772488,37.58571843,10
이마트 경기광주점,9,9,127.2612672,37.40995761,18
이마트 계양점,5,5,126.7368991,37.53104994,10
이마트 과천점,5,5,126.9918429,37.42630485,10
이마트 구로점,17,17,126.8978731,37.48437273,34
이마트 남양주점,4,4,127.2430126,37.65505296,8
이마트 다산점,5,5,127.1578598,37.60799503,10
이마트 목동점,5,5,126.8702986,37.52556124,10
이마트 미아점,3,3,127.0298456,37.61085026,6
이마트 별내점,5,5,127.1260051,37.64284385,10
이마트 보라점,3,3,127.1051281,37.24760023,6
이마트 부천점,9,9,126.7827697,37.48396941,18
이마트 서수원점,3,3,126.969954,37.28290176,6
이마트 성남점,5,5,127.1414103,37.444012,10
이마트 성수점,20,20,127.0531806,37.54013561,40
이마트 수색점,4,4,126.8987221,37.57984531,8
이마트 수서점,5,5,127.1034485,37.48753772,10
이마트 수원점,5,3,127.0216638,37.24993537,8
이마트 수지점,4,4,127.0833553,37.31981961,8
이마트 신촌점,3,3,126.9360009,37.5549778,6
이마트 여주점,9,9,127.6356222,37.28424899,18
이마트 영등포점,5,5,126.9033311,37.51744963,10
이마트 왕십리점,8,8,127.0387357,37.56170392,16
이마트 용산점,13,13,126.9657882,37.52968201,26
이마트 용인점,4,4,127.1890982,37.23143569,8
이마트 원주점,3,3,127.9190743,37.32071263,6
이마트 은평점,5,5,126.9201785,37.60027465,10
이마트 의정부점,9,9,127.1022341,37.74318604,18
이마트 자양점,4,4,127.0733943,37.53841288,8
이마트 죽전점,4,4,127.1099344,37.32534827,8
이마트 진접점,5,5,127.1818402,37.70892802,10
이마트 창동점,4,4,127.047227,37.65179259,8
이마트 춘천점,5,5,127.7185711,37.86383036,10
이마트 파주점,3,3,126.7508547,37.7470926,6
이마트 평촌점,5,5,126.9636473,37.39492964,10
이마트 포천점,21,20,127.1603886,37.84776146,41
이마트 하남점,12,13,127.2056172,37.55276274,25
이마트 하월곡점,4,3,127.0312927,37.60471234,7
이마트 흥덕점,5,5,127.0733302,37.27575474,10
이마트24 R 성남남한산성점,3,3,127.1673577,37.46087029,6
이마트24 R종로성대점,4,4,126.9977176,37.58387113,8
이마트24 R판교알파돔2호점,5,5,127.1103466,37.39420437,10
이마트24 SELF가평오하브점,3,3,127.5269013,37.89612108,6
이마트24 가평경춘로점,3,3,126.494588,33.26205117,6
이마트24 부평해물탕거리점,4,4,126.7296866,37.49436288,8
이마트24 센트럴시티점,4,3,127.0042389,37.50508048,7
이마트24 시흥월곶점,4,4,126.7396615,37.39423057,8
이마트24 양수리연꽃점,5,5,127.3241922,37.54152259,10
이마트24 오산세마역점,4,4,127.0419314,37.18747102,8
이마트24 정독천수점,5,5,126.98214,37.57965675,10
이마트24 파주스튜디오9점,3,3,126.8802693,37.9540906,6
이마트24 한강망원지구점,3,3,126.8959925,37.55389427,6
이마트타운 킨텍스점,4,4,126.7441185,37.66160109,8
이마트트레이더스 고양점,14,14,126.8928926,37.64637906,28
이마트트레이더스 구성점,3,3,127.1050501,37.30502538,6
이마트트레이더스 군포점,4,5,126.9346523,37.34010054,9
이마트트레이더스 김포점,8,7,126.7308512,37.61240495,15
이마트트레이더스 동탄점,9,9,127.0972851,37.19363143,18
이마트트레이더스 부천점,10,10,126.8135902,37.46123011,20
이마트트레이더스 송림점,3,3,126.6603377,37.48311592,6
이마트트레이더스 스타필드하남점,22,24,127.2238015,37.54567126,46
이마트트레이더스 안산점,3,3,126.7850156,37.33125175,6
이마트트레이더스 안성점,5,5,127.1473174,36.99461783,10
이마트트레이더스 월계점,7,6,127.0613768,37.62794603,13
이마트트레이더스 월계점 이마트월계점,4,4,127.0613966,37.6278127,8
이마트트레이더스 위례점,4,4,127.148383,37.48018806,8
이마트트레이더스 킨텍스점,7,6,126.7440438,37.66224243,13
이맛갈비,5,5,127.3823695,38.05196425,10
이모네손칼국수,3,3,127.0413134,37.27688032,6
이문닭발,5,5,127.052923,37.59191596,10
이문설농탕,11,12,126.9839076,37.57273376,23
이미스 성수,5,5,127.0427298,37.54760734,10
이미커피,3,5,126.9219196,37.557475,8
이밥,2,3,126.9876036,37.57924119,5
이봉창의사역사울림관,3,3,126.9608387,37.54008523,6
이북5도청사,3,3,126.9559816,37.61433085,6
이비스 스타일 앰배서더 서울 용산,11,10,126.9617639,37.53207564,21
이비스스타일 앰배서더 명동,12,12,126.989388,37.56172061,24
이비스스타일앰배서더 서울강남,19,20,127.0570689,37.50511002,39
이비스앰배서더 서울명동,14,14,126.9830628,37.5641886,28
이비스앰배서더 수원 체련장,3,3,127.0312763,37.2591821,6
이비스앰배서더 수원점,25,24,127.0312845,37.25927344,49
이비스앰배서더호텔 인사동,29,30,126.9892554,37.57442696,59
이사갈 집,5,3,126.5225393,33.24640841,8
이삭토스트 고양서정마을점,3,3,126.8454871,37.6187933,6
이삭토스트 당산역점,5,5,126.9026719,37.53381489,10
이삭토스트 부천중동현대점,4,3,126.7612689,37.50255798,7
이삭토스트 서울홍대점,3,4,126.9239876,37.55274521,7
이삭토스트 진접역점,3,4,127.2026103,37.72009144,7
이삭토스트 파주출판도시이채점,4,4,126.6876369,37.71363144,8
이상원미술관,4,4,127.5782904,37.96820638,8
이상의집,3,4,126.9708647,37.578649,7
이서방왕족발보쌈 수원본점,4,4,127.0189919,37.25677115,8
이서휴게소 순천방향,6,6,127.0239019,35.80415045,12
이서휴게소 천안방향,6,7,127.0257997,35.80199063,13
이석덕생면파스타 신촌점,5,5,126.9377664,37.55759794,10
이설함흥냉면,4,5,127.0096633,37.64733638,9
이성당과자점 김포,5,5,126.803168,37.56313556,10
이소안경,4,4,127.01632,37.4947539,8
이솔고등학교,1,1,127.1111362,37.1665768,2
이송제면소,4,5,127.1619815,37.7718698,9
이수곱창,5,5,126.9809003,37.48684264,10
이수아트홀,5,5,127.3878808,36.34652423,10
이수역사거리,3,3,126.9821082,37.48525705,6
이순신장군묘,3,3,126.8799728,37.42264554,6
이스케이프9 본사,2,3,126.781189,37.4863208,5
이스트바이게이트 송도점,3,3,126.6579139,37.38175587,6
이시키,5,4,127.2204872,37.57950625,9
이안만두,5,5,127.0042106,37.50499939,10
이안즈펫 리조트 분양홍보관,3,3,127.0439641,37.51059554,6
이오카츠 광교앨리웨이점,4,4,127.0607291,37.2745743,8
이옥진 시인 마을길,1,1,127.2029896,37.56868787,2
이와수산,3,3,126.5588921,37.26727161,6
이우철한방누룽지삼계탕,3,3,127.1967605,37.00866791,6
이우철한방누룽지삼계탕 수지점,5,5,127.0914968,37.3472536,10
이월로스터스 송파1호점,5,5,127.1100233,37.50970373,10
이이네,5,5,126.9766564,37.55327734,10
이이식당,9,9,127.4458967,37.27713981,18
이인휴게소 천안방향,12,12,127.0696832,36.35265584,24
이임수제왕만두,2,2,127.146397,37.82790104,4
이장님밥상,3,3,126.697488,37.71473109,6
이정웅 스페이스,9,9,127.3875241,37.68921191,18
이정훈제빵소,4,4,127.3552064,37.6363498,8
이제마스터디클럽 홍대점,3,3,126.9257931,37.55681436,6
이조송정떡갈비,4,4,126.7932901,35.13948711,8
이지펜션,5,5,127.4666005,37.81522932,10
이집트경양식,4,3,126.6292642,37.47376378,7
이찌방이야기,3,3,126.9358695,37.55777082,6
이차돌 동대문점,3,3,127.0067371,37.56667998,6
이차돌 응암오거리점,3,3,126.9141313,37.58856292,6
이차돌 일산식사점,3,3,126.8114085,37.6776779,6
이채카페,4,4,126.9859123,37.57867338,8
이천도자기축제,4,5,127.385686,37.29309775,9
이천돌솥밥,4,3,127.4009539,37.31137398,7
이천돌솥밥시골밥상,5,5,127.3967389,37.21670008,10
이천막국수,7,8,127.4095316,37.29887796,15
이천미란다호텔,24,25,127.4509288,37.27617647,49
이천보고가,3,3,127.3480868,37.79857146,6
이천산수유마을,5,5,127.4622972,37.34077593,10
이천생선국수추어탕 본점,3,4,127.4483837,37.20346242,7
이천성모메존칼국수 본점,5,5,126.8248543,37.48904977,10
이천시립박물관,8,8,127.4276,37.27495833,16
이천시립월전미술관,14,13,127.4244412,37.27944964,27
이천쌀문화축제,2,3,127.4451029,37.17976558,5
이천역 경강선,9,9,127.4421679,37.26422576,18
이천터미널,12,12,127.4469357,37.27742062,24
이천테르메덴 카라반캠핑장,9,9,127.2518063,37.2396668,18
이천한식보리밥부페,5,4,126.6918885,37.45740117,9
이천휴게소 하남방향,8,8,127.3783679,37.29380976,16
이촌역 4호선,10,10,126.9745201,37.52237348,20
이촌역 경의중앙선,21,21,126.9735438,37.52241291,42
이촌한강공원,29,29,126.9705266,37.51724044,58
이충문화체육센터,3,3,127.0707261,37.06601928,6
이층양옥,7,9,126.9904051,37.57395262,16
이치하치 행궁점,3,4,127.018511,37.28160753,7
이케아 고양점,73,72,126.8631336,37.62976928,145
이케아 광명점,91,93,126.8828668,37.42432794,184
이케아 기흥점,23,23,127.115682,37.22224577,46
이케아레스토랑,3,3,126.8631237,37.62958727,6
이케아카페,6,6,126.8631237,37.62958727,12
이케이에너지 강산주유소,5,5,127.0228328,37.5779377,10
이코노미호텔 인천부평점,10,10,126.7262422,37.51852164,20
이코복스커피,5,5,127.446267,37.19770283,10
이퀄센세이션,4,5,127.1914872,37.55642652,9
이탈리아마을(피노키오와다빈치),5,5,127.4905532,37.71765206,10
이태리185,5,5,127.0144564,37.28331106,10
이태리상회,4,4,127.3585284,37.24853047,8
이태리소년,5,5,126.7040245,37.45124765,10
이태리회관,3,4,127.5195899,37.36848057,7
이태원 부군당역사공원,10,10,126.9897763,37.53580072,20
이태원 옷가게,4,4,126.2995189,36.7521849,8
이태원거리,72,77,126.9958092,37.53456131,149
"이태원거리, 롯데월드타워몰",1,1,126.9958092,37.53456131,2
이태원블링크안경,5,5,126.9927545,37.53384396,10
이태원앤틱가구거리,4,4,126.9943837,37.5335269,8
이태원역,7,7,126.5690094,37.03159336,14
이태원역 6호선,28,27,126.9943339,37.53452521,55
이태원역교차로,5,5,126.9938858,37.53447112,10
이태원지구촌축제,5,5,126.9343102,33.46099546,10
이태원포토,5,5,126.996617,37.53481361,10
이터스 롯데타임빌라스점,10,11,127.0095471,37.37598632,21
이포어묵,3,3,127.0195345,37.56691642,6
이포에너지 우리주유소,5,5,126.7967061,37.20308774,10
이학순베이커리 광명역점,4,4,126.8817002,37.41613112,8
이학순베이커리 백운호수점,3,2,127.0097559,37.38441629,5
이함캠퍼스,9,9,127.4251127,37.50213159,18
이화교복,4,5,127.0939642,37.51107271,9
이화돈까스,5,5,126.9845769,37.57655587,10
이화여자대학교,12,13,126.9476501,37.56254471,25
이화원,3,4,126.9290207,37.56656153,7
이화주막,4,4,126.9912792,37.57216151,8
이화찹쌀순대,5,5,126.6404789,37.46428381,10
이화촌펜션,2,2,127.4807483,37.82775328,4
이회영기념관,3,3,126.988931,37.55987893,6
익산고속버스터미널,9,9,126.9439548,35.93160225,18
익산역,23,23,126.9462883,35.9402174,46
익선냉삼집 미미네,5,5,127.237103,36.30676543,10
익선동 골목,4,4,126.9901271,37.5737132,8
익선동야장,2,2,126.9895404,37.57235958,4
익선동창화당,2,2,127.0005671,37.26565695,4
익선동한옥거리,71,74,126.9897757,37.57343719,145
익선디미방,5,5,126.989461,37.57353808,10
익선문구사,5,5,126.9905591,37.57343005,10
익선반주,5,5,126.9902874,37.5736751,10
익선세겹살,4,4,126.9907538,37.57332916,8
익선슈팅클럽,10,10,126.9897101,37.57342998,20
익선애뜻,20,22,126.9905953,37.57336518,42
익선주택,5,5,126.9894225,37.57361736,10
익선취향,10,10,126.765162,35.54105659,20
인경화이트하우스,4,5,127.3193717,38.18661367,9
인다바,5,5,126.7009888,37.35180007,10
인더비엣 부평삼산점,3,5,126.7358846,37.50817307,8
인덕원비빔국수 안양점,5,5,126.9790746,37.40010344,10
인덕원역 4호선,5,5,126.9766799,37.40149417,10
인도래작은도서관,5,4,127.0273934,37.27249449,9
인사동 문화의거리,86,92,126.9855916,37.57454678,178
인사동거리,12,14,126.9859022,37.57305874,26
인사동쭈꾸미,15,14,126.9858896,37.57911306,29
인사미술공간,3,3,126.9892221,37.58153889,6
인사센트럴뮤지엄,11,12,126.9840702,37.57439702,23
인사아트프라자 갤러리,5,5,126.9857095,37.57387285,10
인사이트모션 한옥마을,3,3,126.9947394,37.55954056,6
인생곱창 본점,5,4,126.9299394,37.49923208,9
인생국수역전김밥,3,3,126.9076679,37.51566912,6
인생네컷 김포라베니체수변공원점,3,4,126.6788746,37.64051357,7
인생네컷 동탄점,7,7,127.071401,37.20046812,14
인생네컷 문래점,5,5,126.8939182,37.51305547,10
인생네컷 성수점,3,5,127.0537575,37.54304017,8
인생네컷 수원망포점,4,4,127.0561243,37.23963412,8
인생네컷 용인에버랜드1호점,2,3,127.2021398,37.29399685,5
인생네컷 인천송도캐슬점,4,4,126.6428002,37.38496206,8
인생네컷 춘천명동점,3,3,127.7278108,37.87996694,6
인생네컷 파주야당2호점,5,5,126.7600947,37.71489673,10
인생면가,5,5,127.1690679,37.00011968,10
인스텝커피,5,5,127.1093918,37.32151758,10
인쌩맥주 강남점,5,5,127.0253209,37.50025747,10
인쌩맥주 익선점,5,5,126.990695,37.57270026,10
인왕산,44,47,126.9578444,37.58489976,91
인왕산 범바위,5,5,126.957981,37.58161479,10
인왕산 수성동계곡,10,10,126.9629032,37.58224804,20
인왕산 숲속쉼터,5,5,126.9620825,37.5865338,10
인왕산둘레길,8,8,126.9618308,37.57828422,16
인왕산자락길,5,5,126.9647493,37.58319555,10
인왕시장,5,5,126.9431827,37.59092846,10
인의동32,3,3,126.9995019,37.57200686,6
인창도서관 주차장,5,5,127.145555,37.60512588,10
인처골체험마을,4,4,127.2723272,36.94429478,8
인천 개항의 거리,5,5,127.7263815,37.8657861,10
인천 개항장문화재야행,15,15,126.6216803,37.47366226,30
인천 펜타포트락페스티벌,3,2,126.6338527,37.40538418,5
인천SSG랜더스필드,10,10,126.6932761,37.43699869,20
인천개항누리길,3,4,126.6208623,37.47289018,7
인천개항박물관,11,13,126.6205845,37.47328573,24
"인천개항박물관 구,인천일본제1은행지점",4,5,126.620571,37.47326766,9
인천개항장 근대건축전시관,5,5,126.621165,37.47294521,10
인천계양체육관,3,4,126.7495569,37.53234967,7
인천공항1터미널역 공항철도,4,4,126.4525845,37.44752855,8
인천광역시 중구청 제1청사,5,5,126.6217018,37.47366052,10
인천광역시교육청교육과학정보원 인천학생과학관,4,4,126.5080401,37.49089075,8
인천광역시립박물관,5,5,126.65315,37.42075962,10
인천국제공항 제1여객터미널,5,5,126.4526107,37.449983,10
인천그린수소충전소,3,3,126.6200136,37.43865997,6
인천글로벌캠퍼스,3,3,126.6676765,37.37605321,6
인천내리교회,10,10,126.6288121,37.47375515,20
인천대공원,48,49,126.7601726,37.4577613,97
인천대공원 목재문화체험관,5,5,126.7523965,37.46048253,10
인천대공원 어린이동물원,14,13,126.7565254,37.44900322,27
인천대공원 환경미래관,5,5,126.7590924,37.45765458,10
인천대공원역 인천2호선,8,8,126.752852,37.44847661,16
인천대입구역 인천1호선,4,4,126.6395422,37.38620639,8
인천대입구역 인천1호선~김포ktl,3,3,126.6440721,37.3797548,6
인천대학교 송도캠퍼스,5,3,126.6347569,37.37685895,8
인천도시역사관,19,23,126.6359511,37.39281247,42
인천둘레길 10코스,5,5,126.6370406,37.42354044,10
인천둘레길 12코스,5,5,126.6254651,37.47389236,10
인천둘레길 13코스,4,4,126.6041127,37.47381914,8
인천맥주,5,5,126.6221874,37.47150867,10
인천문학경기장,23,24,126.6906514,37.4361521,47
인천문화예술회관,9,10,126.7001098,37.44780313,19
인천배다리헌책방거리,3,3,126.6364058,37.4725588,6
인천상륙작전기념관,9,9,126.6540104,37.41987014,18
인천서점,3,3,126.6206212,37.47272902,6
인천수목원,5,5,126.7534884,37.46186336,10
인천스테이호텔,10,10,126.6495192,37.41928927,20
인천시민애집,13,14,126.6227997,37.47428483,27
"인천시민애집,인천구락부",4,5,126.6227997,37.47428483,9
인천시청역 인천2호선,3,4,126.7011043,37.45691306,7
인천아트센터,4,5,126.6295716,37.39952145,9
인천아트플랫폼,37,36,126.6202583,37.47251342,73
인천어린이과학관,4,4,126.7398954,37.5517723,8
인천역 1호선,57,55,126.6168222,37.47616671,112
인천역 수인분당선,3,4,126.6173984,37.47646861,7
인천역사거리,5,3,126.6175139,37.47509225,8
인천종합관광안내소,5,5,126.6363603,37.39227312,10
인천종합어시장,14,15,126.6065583,37.45412771,29
인천종합터미널,44,41,126.7014824,37.44175394,85
인천지방법원 부천지원,3,3,126.7575396,37.49191133,6
인천차이나타운,300,302,126.6186155,37.47553692,602
인천차이나타운 삼국지벽화거리,7,7,126.6202336,37.47471179,14
인천축구전용경기장,1,2,126.6430023,37.46610068,3
인천하우스,5,5,127.4901045,37.93565087,10
인천항 연안부두,5,5,126.5985422,37.45426294,10
인천항갑문,5,5,126.6037016,37.46690525,10
"인천해송고등학교, 미추홀공원 등",5,5,126.6495067,37.382357,10
인천향교,5,5,126.6869492,37.43953196,10
인천화교역사관,8,10,126.6191588,37.47353703,18
인천화교역사문화관,3,3,126.619742,37.47446153,6
인천환경공단 송도스포츠파크,4,4,126.6183871,37.35120564,8
인천환경공단 송도스포츠파크 캠핑장,10,10,126.6186332,37.34985129,20
인코리아한복,5,5,126.9738044,37.57635395,10
인크커피 가산 플래그십 스토어,5,5,126.8780732,37.47933984,10
인터라켄펜션,15,15,127.4819908,37.71058416,30
인터랙트,1,1,127.0248909,37.50648351,2
인터컨티넨탈 서울코엑스,24,24,127.0572967,37.51273977,48
인터컨티넨탈서울코엑스 브래서리,5,5,127.0571088,37.51294154,10
인투제주 문정도점,4,4,127.1228275,37.48261408,8
인피니티,5,5,127.0511445,37.08135836,10
인피펍 성대점,3,2,126.970654,37.2981439,5
인하대병원,3,3,126.6342705,37.45883349,6
인하대역 수인분당선 1번출구,3,3,126.6496785,37.44764459,6
인하대학교 용현캠퍼스,9,9,126.6543513,37.4493991,18
인하찹쌀순대,4,4,126.7731002,37.48105087,8
인현골방,5,5,126.9945105,37.56415906,10
인현시장,3,3,126.9953956,37.56411044,6
일곱잔,4,4,127.0222749,37.51784749,8
일광전구라이트하우스,5,5,126.6350603,37.47212578,10
일동농협하나로마트 본점,5,5,127.3200364,37.96021557,10
일동농협하나로마트 이동점,11,11,127.3668955,38.03606641,22
일라고,4,4,127.1897222,37.56330848,8
일락 한양대점,3,3,127.0403328,37.55980769,6
일렉트로마트 스타필드고양점,5,5,126.8927344,37.64608249,10
일렉트로마트 스타필드하남점,4,4,127.2256734,37.54539109,8
일로향실,5,5,127.2990969,37.49591595,10
일르,4,4,126.9541165,37.3903149,8
일리에콩브레,4,4,127.130106,37.20361873,8
일미담,5,5,127.0563105,37.90889284,10
일미식당,5,5,127.4112947,38.16420884,10
일미집,13,14,126.9782689,37.54614264,27
일본식당 아유미,4,5,127.0610576,37.20803553,9
일본풍거리,38,38,126.8719262,37.4490971,76
일산문화광장,17,17,126.7708021,37.65859623,34
일산손만두,5,5,126.7964878,37.67742695,10
일산시장,3,3,126.7707451,37.68595342,6
일산역 경의중앙선,15,13,126.7700226,37.68201294,28
일산칼국수,5,5,126.7883788,37.64846601,10
일산칼국수 본점,10,10,126.7861717,37.67048919,20
일산칼국수 서오릉점,4,3,126.8847253,37.6293869,7
일산호수공원,187,191,126.8457398,37.38246842,378
일산호수공원가로수길,7,7,126.7563713,37.66602652,14
일상비일상의틈,20,21,127.0267572,37.50058151,41
일성남한강리조트,4,4,127.6507895,37.30132564,8
일영모자농원캠핑장,14,15,126.9530412,37.70817233,29
일영역 (폐역),2,2,126.9291742,37.70070034,4
일용할양식,5,5,126.6952644,37.44823944,10
일월저수지,3,3,126.972831,37.28820147,6
일인자감자탕 설악점,4,4,127.490131,37.6783446,8
일일양 광교중앙점,5,5,127.0568682,37.28763949,10
일일향 잠실점,4,4,127.1074625,37.51118779,8
일품낙지아구,3,3,126.8372637,37.65623615,6
일품양평해장국,4,4,127.3251536,37.5433878,8
일품양평해장국 미사점,3,4,127.1917413,37.56373138,7
일품양평해장국 용인프라자CC점,5,5,127.1355461,37.13705885,10
일품향,2,2,127.6492578,37.30053755,4
일호갈비탕,5,5,127.2921486,37.66512797,10
일호돼지갈비,2,3,126.558886,33.23853254,5
임자도횟집,3,3,126.7390243,37.40018491,6
임종호커피 파주점,4,4,126.6886956,37.78689617,8
임진각 수풀누리,5,5,126.7460975,37.89651748,10
임진각 전망대 및 경의선 장단역증기기관차,5,5,126.7430603,37.8922482,10
임진각 평화누리,87,87,126.7429874,37.89178708,174
임진각 평화누리 야외공연장,10,10,126.7434134,37.89220966,20
임진각관광지,36,35,126.7431664,37.89064418,71
임진각관광지 바람의언덕,5,5,126.7432566,37.89282916,10
임진각평화곤돌라,7,11,126.7402851,37.89145681,18
임진각평화곤돌라 DMZ탑승장,2,4,126.7322787,37.89540303,6
임진각평화누리전통놀이체험장,3,3,126.7436541,37.89163177,6
임진강 독개다리,4,5,126.7359511,37.89057776,9
임진강 평화 전망대,5,5,126.7430603,37.8922482,10
임진강댑싸리공원,55,59,127.0170948,38.1312483,114
임진강주상절리,3,3,127.0154196,38.01863018,6
임진강주상절리카약,4,4,127.0139573,38.01829882,8
임초1교,4,4,127.3630821,37.75001493,8
임학역 인천1호선,3,4,126.7386334,37.54501205,7
입장거봉포도휴게소 서울방향,3,3,127.1927118,36.9430053,6
잇다스페이스,4,4,126.6344672,37.47227711,8
잇다제과,4,4,127.1879985,37.74719878,8
잇뽀,5,5,127.1080333,37.51404571,10
잇츠콜라박물관,8,9,126.7004293,37.78808071,17
잇타이플러스 판교점,5,5,127.0975661,37.41237207,10
잇탈리 헤이리점,9,9,126.6987563,37.78797374,18
잉글랜드 돈까스,5,5,129.2231431,35.18840282,10
잉글랜드왕돈까스,2,2,126.631021,37.47422339,4
잎차,5,5,126.9850225,37.54505168,10
자라게스트하우스,3,3,127.5145185,37.81641722,6
자라섬,121,126,127.5279467,37.81575236,247
자라섬 voyage 축제 음식 부스 방문,3,3,127.5279809,37.8167048,6
자라섬 꽃테마공원,40,39,127.5282574,37.81600504,79
자라섬 남도,5,5,127.5354401,37.81043177,10
자라섬재즈페스티벌,48,48,127.5267345,37.81713444,96
자라섬캠핑장,49,49,127.5210562,37.82087791,98
자매공원,3,3,127.4958529,36.72202246,6
자양한양아파트,4,3,127.0909629,37.53199273,7
자연과사람들펜션,2,2,127.3537145,37.94227706,4
자연초밥,5,5,126.7726406,37.65477603,10
자유공원,37,36,126.6219706,37.47550304,73
자유공원 맥아더장군동상,9,9,126.6234122,37.47479044,18
자유공원 산책로,4,4,126.6224093,37.47638382,8
자유제일주유소,3,3,126.8219122,37.60417128,6
자작나무갈비 하남미사점,5,4,127.202923,37.57334612,9
자작나무이야기,4,4,126.9818436,37.57867823,8
자잠157,14,14,127.490805,37.69013189,28
자하슈퍼,2,3,126.9627935,37.6002309,5
작가,3,3,126.9211994,37.55141261,6
작당모의,8,8,126.9254023,37.56058162,16
작살치킨 송파구청점,3,3,127.1083508,37.51464819,6
작은연필가게 흑심,14,14,127.4987868,37.13126457,28
작전역 인천1호선,5,5,126.7225608,37.5302711,10
잔상,8,9,126.983442,37.51688742,17
잘빠진메밀 서촌점,4,4,126.970982,37.57966895,8
잘빠진메밀 익선동점,2,3,126.9914872,37.57403919,5
잠보,5,5,126.9794268,37.56560439,10
잠수교,4,4,126.9968284,37.51389234,8
잠수교집 여의도점,10,10,126.9310478,37.52622501,20
잠실 롯데월드타워 월드파크,5,5,127.1025353,37.5125585,10
잠실공원,4,4,127.0867236,37.5175896,8
잠실광역환승센터,17,17,127.1003419,37.51331096,34
잠실벨솔레오피스텔,10,10,127.1113146,37.51636725,20
잠실역 2호선,29,27,127.100231,37.51331106,56
잠실역 8호선,4,4,127.1032705,37.51431216,8
잠실역 지하버스환승센터,4,4,127.1001021,37.51329855,8
잠실역지하상가,3,3,127.1003916,37.51331633,6
잠실올림픽공원아이파크아파트,4,4,127.1142467,37.52535195,8
잠실종합운동장,36,35,127.0730249,37.51459062,71
잠실종합운동장 실내체육관,10,10,127.075981,37.51617812,20
잠실종합운동장 올림픽주경기장,38,38,127.0727886,37.51585217,76
잠실종합운동장 잠실야구장,37,37,127.0719095,37.51215138,74
잠실한강공원,19,18,127.0823578,37.51779926,37
잠원한강공원,37,37,127.0181999,37.5265029,74
잠원한강공원 6주차장,5,5,127.0090268,37.518343,10
장경리해변,3,2,126.4489408,37.27204767,5
장기고등학교,2,2,126.6684116,37.64015667,4
장기역 김포골드라인,5,5,126.6690786,37.64406519,10
장내동육칼,4,5,126.919951,37.39788331,9
장단콩맛집,6,6,126.8265359,37.90605223,12
장도포대지,4,4,126.7382531,37.39720984,8
장독대김치찌개 청담점,5,5,127.0530732,37.52435282,10
장독바위쌈밥,5,5,127.1952463,37.7336941,10
장릉,18,19,126.7106992,37.64510334,37
장보고,4,4,126.919738,37.95412955,8
장사랑 신세계프리미엄아울렛 파주점,5,4,126.6964513,37.76948192,9
장생관,6,7,127.1091944,37.51525108,13
장세소고기무한리필 일산본점,5,5,126.7541546,37.67903113,10
장수갈매기 본점,5,5,126.9507119,37.54170143,10
장수동 은행나무,4,4,126.7696546,37.46024172,8
장수보쌈,4,4,127.0024223,37.56807849,8
장수뼈해장국,5,5,127.517715,37.85910802,10
장수원,5,5,127.0173454,37.56710056,10
장수족발,5,5,126.9533261,37.54475688,10
장수촌,8,8,127.179231,37.62924725,16
장수하늘소 인사점,5,5,126.9855895,37.57381698,10
장수홍두깨즉석칼국수,4,4,126.7703476,37.38291425,8
장승다담공원,5,4,127.1941714,37.73040914,9
장승포시외버스정류장,5,5,128.7308752,34.87538829,10
장안공원,3,3,127.0114253,37.49166222,6
장안공원 화서문,9,9,127.0096868,37.28557315,18
장안면옥,3,3,127.0999492,36.99524926,6
장안문,95,95,127.0142432,37.28886148,190
장안순대국,3,3,127.0144388,37.28549698,6
장안통닭,23,23,127.0178475,37.27942712,46
장암역 7호선,3,3,127.0528183,37.69995657,6
장어독립,3,5,127.3478859,37.82835759,8
장어먹은소 이천점,5,5,127.4473932,37.28156724,10
장어의꿈,13,13,127.127686,37.61871134,26
장원김밥,5,5,127.009639,37.49379596,10
장원숯불고기우렁쌈밥,1,2,127.4290891,37.50413185,3
장인더카페,16,14,127.2043807,37.89432729,30
장자호수공원,8,8,127.1412795,37.58580483,16
장작집,3,3,127.4477071,37.27897108,6
장지천,5,5,127.0847928,37.16103996,10
장충단공원,14,14,127.0047863,37.55872608,28
장충당 역촌점,5,5,126.9191318,37.60062712,10
장충쭈꾸미& 양푼김치탕,3,4,127.0060146,37.56209935,7
장충체육관,8,8,127.0068088,37.55817817,16
장터대박조개구이,5,5,126.5976895,37.47672751,10
장터집,9,9,128.1958981,37.62201991,18
장통교 진출입 계단 5번,5,5,126.9846193,37.56866496,10
장항습지,4,4,126.7431318,37.64404064,8
장혁민의부대찌개 인천시청점,5,5,126.7063855,37.4521041,10
장호덕손만두 배곧 한라비발디점,5,5,126.7844128,37.49293291,10
장흥관광지,3,4,126.9517052,37.73278636,7
장흥농협하나로마트,3,3,126.9412225,37.71623976,6
장흥농협하나로마트 송추점,4,3,126.9763129,37.71923965,7
장흥조각공원,3,3,126.9488011,37.7311252,6
장흥조각공원 열린마당,5,5,126.9494141,37.73205741,10
장흥참숯가마,5,5,126.9598349,37.74462454,10
장흥회관,5,5,127.4388742,37.28022236,10
재본소,5,5,126.9235146,37.39851999,10
재신,4,4,126.9107615,37.55463075,8
재인폭포,65,69,127.1433186,38.07733438,134
재커스테이블,3,3,127.1517392,37.62284413,6
재희네식당,5,5,127.0709454,37.54515385,10
잭니클라우스골프클럽코리아,2,2,126.6243924,37.38046931,4
잭스바,2,3,126.9924059,37.53505128,5
잭슨피자 압구정점,4,4,127.0246029,37.52497937,8
잭슨후라이드치킨 한남점,4,4,127.0071741,37.53210774,8
잭의 잡화점,3,3,126.9214075,37.56449432,6
잼라운지,5,5,127.0464875,37.50502456,10
쟝블랑제리,3,4,126.981326,37.48437394,7
저녁바람이부드럽게,1,2,127.2988732,37.51737595,3
저스트텐동 양평점,5,5,127.5998158,37.51926378,10
저스트텐동 행리단길점,5,6,127.0146594,37.28332005,11
저스트플레이호스텔 라페스타점,5,5,126.7659863,37.66341242,10
저스티나,5,5,126.9107944,37.54790753,10
저현어린이공원,4,3,126.8106045,37.67601251,7
적당,9,9,126.9810407,37.56646421,18
적목리,5,5,128.9882508,35.16942499,10
전곡선사박물관,17,17,127.0641094,38.0116045,34
전곡전통시장,3,3,127.0684476,38.0247303,6
전곡종합수산시장,2,2,126.653734,37.18730043,4
전곡항,8,8,126.6504395,37.18762234,16
전곡항마리나,8,8,126.6511173,37.18618987,16
전광수커피하우스 정동점,5,5,126.9724746,37.56592733,10
전국5대짬뽕연화산,5,5,127.099597,37.39178836,10
전국낙지자랑 본점,3,3,127.1297583,37.51657368,6
전대.에버랜드역 에버라인,21,21,127.219509,37.28541327,42
전등사,5,5,126.4847789,37.63214569,10
전라도대왕조개구이랑칼국수,10,10,126.5980239,37.47592856,20
전라도밥상,7,8,126.9186961,37.77585335,15
전라도여수식당 본점,4,4,127.0884601,37.79261871,8
전설의사발떡볶이,3,3,126.9941016,37.61030609,6
전싸롱,4,4,127.0298934,37.26496839,8
전쟁기념관,31,33,126.9771074,37.53701761,64
전쟁기념관 어린이박물관,9,11,126.9766082,37.5371981,20
전주고속버스터미널,58,57,127.1292206,35.83450993,115
전주고을퇴촌순두부,5,5,127.3838419,37.47582308,10
전주김밥 본점,3,3,126.996274,37.56140027,6
전주돌솥밥 계산점,5,5,126.7371399,37.53465447,10
전주밥차,3,3,126.9797773,37.57545413,6
전주시외버스공용터미널,21,21,127.1326724,35.83437999,42
전주식당,4,4,126.6562515,37.46288192,8
전주이씨 광평대군파묘역,2,2,127.0921878,37.48665324,4
전주콩뿌리 콩나물국밥 삼전점,3,3,127.0969096,37.50416773,6
전주현대옥 미사역점,5,5,127.1909362,37.56225506,10
전주현대옥 상암DMC점,3,3,126.8921107,37.57903847,6
전축,4,5,126.9928082,37.56324806,9
전통설렁탕,4,4,126.9972463,37.59262876,8
전통술박물관산사원 본원,29,30,127.3090752,37.90567695,59
전통우리밀칼국수전문,4,3,126.5693586,37.28395043,7
전통주갤러리,15,15,126.9858377,37.57840307,30
전통찻집지대방,5,5,126.9855465,37.57348721,10
전티마이쌀국수,4,4,126.4915685,37.49338345,8
젊음의거리,3,5,126.985733,37.56923453,8
점보씨푸드 IFC몰점,3,4,126.9257772,37.52498294,7
정가네만두샤브,4,4,126.8087862,37.5127348,8
정가네식당,4,4,126.9460393,37.47953369,8
정극장,5,5,127.0039511,37.58102574,10
정금마을,5,5,126.9810385,37.49464539,10
정금족발,2,2,127.1748002,37.57171527,4
정남옥,3,3,126.9345496,37.47255587,6
정남진장흥농협하나로마트,3,3,126.9040086,34.68242009,6
정다운돌솥밥생선구이,4,4,127.3083272,38.15410988,8
정담은코다리조림동태탕,5,5,127.1031514,37.5461176,10
정도가 이천 도자기체험공방,5,5,127.3890047,37.29630898,10
정돈,10,10,127.0010948,37.58178895,20
정돈 강남점,4,5,127.0264417,37.50393513,9
정돈 성수점,5,5,127.0433502,37.54414907,10
정라멘,3,4,127.091027,37.50651953,7
정릉시장,4,4,127.0094771,37.60842098,8
정무네장어집,5,5,126.9213535,35.14733372,10
정미소,1,2,127.4886638,37.5271497,3
정미식당 본점,2,2,126.7933689,37.8493075,4
정발산,33,33,126.7794052,37.66346982,66
정발산역 3호선,4,4,126.773406,37.65948062,8
정샘물 플롭스,5,5,127.0224977,37.52135416,10
정서진광장,12,12,126.6055631,37.55742221,24
정석그라시아오피스텔,5,4,126.9996152,37.5642619,9
정성,4,4,126.9033798,37.56038772,8
정세이카츠,5,5,126.5716053,33.24499661,10
정안알밤휴게소 논산방향,22,22,127.1121964,36.57115105,44
정안알밤휴게소 천안방향,30,28,127.1150787,36.56952723,58
정안휴게소주유소 순천방향,5,3,127.1125225,36.56952967,8
정암수목공원,5,5,127.0776601,37.29788508,10
정애네손만두어묵,4,4,127.017337,37.27607532,8
정약용문화제,2,4,127.2996095,37.51678844,6
정약용유적지,25,27,127.2996095,37.51680285,52
정약용유적지 생가,13,13,127.3001193,37.51670335,26
정왕역 수인분당선,3,4,126.7422611,37.35201252,7
정원속화실담다,4,5,126.9080426,37.55323032,9
정육면체,5,5,126.9345529,37.55678351,10
정읍공용버스터미널,3,3,126.8454471,35.57299966,6
정읍역,20,20,126.8422496,35.57550653,40
정인면옥 본점,2,2,126.9215741,37.53077817,4
정정아식당 경기광교점,3,3,127.0444519,37.2988465,6
정정아식당 부평점,2,4,126.7262333,37.49370621,6
정정아식당 송도직영점,4,4,126.6513521,37.39454919,8
정지영커피로스터즈 장안문점,5,5,127.0136679,37.28793348,10
정지영커피로스터즈 행궁본점,16,19,127.0144116,37.28488788,35
정지영커피로스터즈 화홍문점,21,23,127.0172222,37.28689142,44
정직한제빵소,5,5,127.1136983,37.76344279,10
정통밥집,5,5,126.9500807,37.31157416,10
정통집 강남직영점,4,4,127.0281208,37.499955,8
정통집 방이점,5,5,127.1093272,37.51404001,10
정통집 영등포점,4,4,126.9076479,37.51724766,8
정통집 홍대점,5,5,126.9216659,37.55120028,10
정평천자전거길,3,3,127.0796034,37.3224424,6
제니스호텔,5,5,126.7276659,37.49156513,10
제로띵스,3,3,126.9903113,37.5639876,6
제로마트,4,4,127.0697573,37.14378457,8
제로월드 강남점,5,5,127.0245815,37.50093338,10
제로월드 서현직영점,5,5,127.1246202,37.38549443,10
제리백 에스플래닛,2,2,127.0408556,37.5471611,4
제물포구락부,24,25,126.6225221,37.47463623,49
제물포역 1호선,14,14,126.6574939,37.46681933,28
제부도,8,9,127.7693415,37.48168429,17
제부도 빨간등대,8,8,126.6220928,37.17945831,16
제부도 워터워크,5,5,126.6558211,37.1740899,10
제부도경하네,3,3,126.6576916,37.17281222,6
제부도아트파크,4,4,126.6175076,37.17001501,8
제부도임시공영주차장,3,3,126.6177436,37.16966977,6
제부도케렌시아,2,3,126.6610866,37.16748415,5
제부도해수욕장,17,16,126.6170193,37.16772476,33
제부도해안산책로,8,8,126.6181795,37.17612991,16
제부비치콘도,6,6,126.6184385,37.16493068,12
제빵소굽다,4,4,126.6999673,37.7259599,8
제빵집,5,5,126.7820015,37.438594,10
제스티살룬 연남점,4,5,126.9268522,37.56171284,9
제시,2,3,127.0037643,37.58181863,5
제이네,3,4,126.9818142,37.57872327,7
제이드가든수목원,18,20,127.5433139,37.83112831,38
제이드팰리스GC,5,5,127.5484919,37.83088628,10
제이드펜션,10,10,127.5369244,37.835056,20
제이바웃커피,2,2,127.104215,37.51185069,4
제인마치메종,3,3,127.0479227,37.54227503,6
제일갈비,7,7,127.4434457,37.28141991,14
제일바다낚시,2,3,126.602449,37.45497172,5
제일식당,4,4,127.6499135,37.31278062,8
제일약국,5,5,129.0859947,35.17549992,10
제일유황온천,13,13,127.3286995,37.9676514,26
제일제면소 올림픽공원점,5,5,127.1287702,37.51689642,10
제일족발,3,3,127.0246188,37.25576095,6
제일콩집,4,4,127.0776536,37.61947797,8
제일평화시장,12,12,127.0114099,37.5684672,24
제주공항,10,10,126.4913534,33.5104135,20
제주국제공항,98,94,126.492769,33.50707896,192
제주국제공항 국내선출발 3번게이트,4,4,126.4929483,33.50659644,8
제주도그릴 특상본점,5,5,126.922414,37.60456125,10
제주둘레국수 용인역북점,2,4,127.1864461,37.2307551,6
제주면장 남산서울타워점,2,2,126.9878674,37.55112293,4
제주시성수동,4,4,127.0562242,37.53992697,8
제주은희네해장국,4,4,126.8290064,37.56040074,8
제주은희네해장국 고양삼송점,4,4,126.8970927,37.64910647,8
제주은희네해장국 송추점,4,4,126.9727681,37.71722431,8
제주은희네해장국 시흥장현점,5,5,126.7869153,37.37695346,10
제주은희네해장국 일산본점,3,3,126.7993923,37.67647689,6
제주흑돈,4,4,126.7462082,37.67629425,8
제줏간,3,3,126.7564513,37.50667655,6
제줏간 부평점,5,5,126.7263406,37.49157288,10
제줏간 송도더테라스점,5,5,126.6262048,37.41114026,10
제천역,10,10,128.205411,37.12806457,20
제천인두꺼비식당 평택AK프라자점,5,5,127.0851708,36.99084998,10
제철쌈밥,5,5,126.9970942,37.30856077,10
젠젠 본점,5,5,126.6565989,37.38092222,10
젠젠 잠실점,5,5,127.1080386,37.51067505,10
젠틀몬스터 하우스도산,5,5,127.0356805,37.52536938,10
젤라떼리아도도 청담점,4,4,127.036925,37.52539242,8
젤라뚜또 스타필드하남,4,5,127.2237176,37.5454148,9
젤라띠젤라띠 송파구청점,10,10,127.1062216,37.51352026,20
젤라띠젤라띠 이태원점,4,4,126.9919488,37.53483051,8
조가네뼈다귀감자탕,2,2,126.879334,37.4616453,4
조개브라더스,4,4,126.6873785,37.34384307,8
조개상사,4,4,126.6790464,37.46432458,8
조개포차,15,17,126.6866239,37.34183358,32
조개폭식 연신내점,5,5,126.9195174,37.61694971,10
조계사,28,29,126.9818561,37.57395882,57
조리고 인계점,2,3,127.0344703,37.2644995,5
조리인,5,5,127.0386032,37.52420166,10
조마담칼국수,4,4,127.0161013,37.27645394,8
조마루 동두천점,4,4,127.053226,37.901757,8
조만간식당,3,3,126.5600651,37.27687018,6
조무락닭갈비,14,14,127.5249866,37.80797419,28
조부자매운순대가 명동점,5,5,127.7298669,37.87949474,10
조선곰탕,5,5,127.0578647,37.9434747,10
조선김밥,5,5,126.9822138,37.57862242,10
조선델리,4,4,126.9800927,37.56447646,8
조선시대,5,5,126.9215059,37.55264538,10
조선식당,1,1,127.0021511,37.58270705,2
조선쌈밥,4,5,126.4519614,33.50179497,9
조선팰리스 서울강남,10,10,127.0413471,37.50287487,20
조수영성형외과의원,5,5,127.0216307,37.51185774,10
조안사계절찐빵만두,4,4,127.302624,37.53499535,8
조앤도슨,4,5,126.9231967,37.56364586,9
조앤박의원,4,4,127.0203874,37.51518807,8
조양마트 조양시장점,5,5,127.0671628,37.53911666,10
조은도너츠,5,5,126.7890382,37.77409515,10
조인폴리아 파주농장,10,10,126.8013867,37.7795332,20
조치원역,17,17,127.2961734,36.60109729,34
족황상제 압구정로데오점,5,5,127.0382736,37.52567491,10
존라멘,4,4,126.9989972,37.56299239,8
존앤맷 미사본점,4,4,127.1949412,37.56419646,8
존앤진피자펍 행궁본점,27,28,127.013237,37.28737489,55
종각역 1호선,14,14,126.9831508,37.57022799,28
종로3가,5,5,127.2443921,36.28842062,10
종로3가 정류장,5,5,126.9898635,37.5702856,10
종로3가역 1호선,11,12,126.9921533,37.57042084,23
종로3가역 3호선,5,5,126.9918758,37.57156329,10
종로3가역 5호선,13,13,126.9904177,37.57258941,26
종로5가역 1호선,4,5,127.0015383,37.57097611,9
종로고집,1,3,126.9912158,37.5724282,4
종로구립 고희동미술관,4,4,126.9888958,37.58314623,8
종로구청,3,3,126.97899,37.57350424,6
종로귀금속거리,3,4,126.9928821,37.57181563,7
종로빈대떡 2호점,3,3,127.0172972,37.59365466,6
종로빈대떡 광화문점,4,4,126.9752867,37.57154296,8
종로살롱,5,5,126.9738191,37.57636026,10
종로풍,4,4,126.9542907,37.47900558,8
종로하루,5,5,126.9965518,37.57497468,10
종묘,86,87,127.0008647,37.54577226,173
종묘 외 시티투어,5,5,126.994213,37.57610804,10
종묘-창경궁 산책로,5,5,126.9873561,37.56318453,10
종묘귀금속전문백화점,5,5,126.9969799,37.57096527,10
종암사거리입구 정류장,5,5,127.032994,37.601498,10
종이미술관,5,5,126.5759863,37.22451673,10
종점가든,5,5,127.4903779,37.59538705,10
종친부 경근당,5,5,126.9813205,37.57887817,10
종합상가,5,5,127.1461496,37.4408286,10
종합운동장역 2호선,4,4,127.0738494,37.51114466,8
종합운동장역 2호선 8번출구,4,4,128.8342043,37.87985546,8
종합운동장역 9호선,6,6,127.0763245,37.51140979,12
좋은날좋은떡,5,5,126.7749287,37.77060575,10
좋은씨앗,10,9,126.9851207,37.57464403,19
좋은아침페스츄리 양평점,5,5,127.4913201,37.50852413,10
좌상바위,4,4,127.1029203,38.03779387,8
죠스떡볶이 소하지구점,5,4,126.8834887,37.44731886,9
죠스떡볶이 수서벤처빌점,4,4,127.1016321,37.48804386,8
죠스떡볶이 일산웨스턴돔점,2,3,126.7727908,37.65716752,5
죠지서울,2,3,126.9912029,37.5660095,5
주공5단지아파트,15,15,126.9957338,37.42913966,30
주공그린빌8단지아파트,5,5,126.8375332,37.31066944,10
주교좌 답동성바오로성당,5,5,126.6298992,37.47109159,10
주렁주렁 동탄라크몽점,5,5,127.1051975,37.16689038,10
주렁주렁 하남점,4,4,127.2236177,37.54362635,8
주록계곡,5,5,127.4730269,37.37386582,10
주록리마을회관,3,4,127.4734391,37.37549321,7
주류창고,5,5,127.2535719,37.33558949,10
주식회사 마운틴누크,10,9,127.1082342,37.5106145,19
주안역 1호선,8,8,126.6799679,37.46505239,16
주엽역 3호선,13,12,126.8920301,37.05178094,25
주주팜,5,5,127.6560884,37.20202291,10
죽림동 주교좌성당,3,3,127.7272241,37.87659208,6
죽마고우,3,3,126.9046982,37.13101587,6
죽미령평화공원,4,4,127.0521156,37.18559999,8
죽백근린공원,5,5,127.1218509,36.99829608,10
죽산순교성지,4,4,127.4497445,37.07589962,8
죽산시외버스터미널,7,7,127.4270649,37.07597624,14
죽암휴게소주유소 서울방향,3,3,127.430163,36.49774597,6
죽여주는동치미국수,5,5,127.3219596,37.56831975,10
죽전역 수인분당선,3,4,127.107505,37.32437738,7
죽전휴게소 서울방향,14,13,127.1047768,37.33240262,27
죽주산성,5,5,127.4314534,37.08915192,10
준179,2,2,126.7060575,35.98616961,4
준게스트하우스,28,28,126.9275565,37.5544152,56
줄서시오1950,4,4,127.0574577,37.9159719,8
줌모텔,2,2,127.096961,37.50546244,4
중3리회관,5,5,127.2070658,38.08863414,10
중계역 7호선,5,5,127.0641104,37.64509212,10
중곡역 7호선,3,3,127.0843124,37.56592206,6
중국성,5,5,127.4236296,37.74219432,10
중국제과담,4,4,126.619735,37.47583825,8
중남미문화원,8,10,126.89541,37.7039764,18
중대물빛공원,8,9,127.2203681,37.40045497,17
중랑장미공원,5,5,127.0732684,37.61552724,10
중랑천,4,4,127.0708474,37.58979284,8
중마루공원,3,3,126.9115453,37.51966173,6
중미산막국수,2,2,127.4671742,37.53520776,4
중미산천문대,2,3,127.4593725,37.58175195,5
중부식자재할인마트,5,4,126.5548917,37.64645384,9
중앙감속기,5,5,127.0510842,37.54557497,10
중앙경제HR교육원,4,4,127.0092032,37.55471097,8
중앙공원,5,5,126.6997057,37.44598927,10
중앙대학교 서울캠퍼스,4,3,126.9550496,37.50487739,7
중앙시장,4,4,127.2687255,37.00680573,8
중앙식당,3,3,126.9770788,37.55977992,6
중앙식자재마트 파주금촌역점,4,4,126.7765138,37.76814103,8
중앙약국,3,3,127.0683387,37.83716914,6
중앙탑사적공원,4,4,127.8662637,37.01821772,8
중앙해장,10,10,127.0654725,37.5082736,20
중원계곡,4,4,127.6168511,37.55331263,8
중원산,4,3,127.6018189,37.55865827,7
중평떡볶이 본점,4,4,127.0316224,37.2639804,8
중화루,17,17,126.6237844,37.47179308,34
중화요리광장,5,5,127.4227243,37.73701163,10
쥬뗑뷔뜨,5,5,127.1065734,37.5031647,10
쥬벤쿠바 연남,5,5,126.9220176,37.56548312,10
쥬씨 구로깔깔거리점,3,3,126.9004674,37.48311894,6
쥬씨&고망고 서울숲점,4,4,127.0447215,37.5476985,8
쥬씨&차얌 상계역점,4,4,127.0736974,37.6602217,8
즉석손바지락칼국수,4,4,126.9291472,37.49986051,8
증산역 부산2호선,5,5,129.0102882,35.30825807,10
증평시외버스터미널,9,9,127.5825291,36.78584808,18
지강낙곱새 압구정본점,4,4,127.0295539,37.52632974,8
지강낙곱새 잠실점,5,5,127.1063646,37.51387153,10
지구샵 연남점,3,3,126.9235229,37.56455608,6
지구에서온아구해,5,5,127.1832081,37.52114122,10
지노,5,5,126.6864427,37.8010037,10
지동벽화마을,4,3,127.0228409,37.28109138,7
지동시장,29,30,127.0193941,37.27779419,59
지리산어탕국수 행주본점,4,5,126.828321,37.60064529,9
지마트,5,5,126.8403267,37.3067204,10
지붕위에커피잔,4,4,127.5150263,37.81366531,8
지브로S 게스트하우스,1,1,126.9238779,37.54821763,2
지수당,4,4,127.1898164,37.47590844,8
지수화풍,5,5,126.9515066,37.54460568,10
지식정보단지역 인천1호선,3,3,126.6458614,37.37750722,6
지안힐링라운지,15,15,127.4925634,37.59849895,30
지오다노 스타필드고양점,4,3,126.8958429,37.64745477,7
지오다노 여의도IFC몰점,5,5,126.9254937,37.52560355,10
지유가오카핫초메 선릉점,4,4,127.0472777,37.50274831,8
지유명차 부천점,10,10,126.7688825,37.48451158,20
지인 집,4,3,126.5021733,33.50404178,7
지인과 이른저녁식사(스즈란데이),3,3,126.9741664,37.5199927,6
지장산막국수 본점,5,5,127.2070874,38.08939177,10
지장산막국수 어룡동점,2,2,127.1846721,37.8786244,4
지지고 성신여대점,5,5,127.017392,37.59218783,10
지지배배한복 2호점,3,3,126.7869153,37.37695346,6
지지밸리유명산장 오토캠핑장,15,15,127.49139,37.61567294,30
지지향게스트하우스,8,8,126.6867921,37.70848286,16
지진옥외대피장소 옹달샘(어린이)공원,3,2,126.902065,37.55489776,5
지코바 초전점,3,4,128.1133925,35.21246235,7
지투존 영등포점,5,5,126.908055,37.51729843,10
지하102호 2호점,3,3,126.9174347,37.54999637,6
지하102호 3호점,2,2,126.9180793,37.54938775,4
지혜의숲,62,62,126.6870602,37.70835383,124
직동근린공원,5,5,127.0323208,37.74014373,10
직탕폭포,4,4,127.2656643,38.20960592,8
직화볶음찜닭 볶찜 신길점,5,5,126.9209472,37.50303586,10
직화한상 스타필드코엑스몰점,1,1,127.059733,37.51161937,2
진가와 잠실롯데월드몰점,3,3,127.1038352,37.51368997,6
진고개,5,5,127.0112882,37.57203875,10
진관사,23,24,126.9469083,37.6380555,47
진구곱창,8,9,127.0248076,37.50075313,17
진달래카페&밀면,5,5,126.7973864,37.5008703,10
진도가든,4,5,127.4370557,37.40081847,9
진도식당,5,5,126.2391575,33.39386608,10
진두꺼비식당,4,4,126.8661182,37.54913574,8
진루아쏘,5,5,127.4132803,37.73549546,10
진미,4,4,126.8969017,37.6494481,8
진미떡볶이 광주점,3,3,127.2566085,37.41875903,6
진미분식,3,3,126.9436783,37.51308878,6
진미옥설렁탕,3,3,127.0529766,37.90908359,6
진미통닭,88,90,127.0181226,37.27963251,178
진미평양냉면,5,5,127.0360472,37.51613579,10
진부(오대산)역,5,5,128.5743773,37.64277311,10
진성 삼계탕,5,5,127.1454049,37.441023,10
진심,5,5,126.9688491,37.5798414,10
진안건강원(흑염소),5,5,127.1324751,37.441767,10
진약국,4,4,127.0584243,37.65350305,8
진영복합휴게소 부산방향,5,5,128.7173477,35.27738158,10
진옥화 할매원조닭한마리 본점,6,6,127.005696,37.57033808,12
진옥화할매원조닭한마리 본점,2,3,127.005696,37.57033808,5
진작,16,18,126.9908362,37.56401737,34
진작다이닝,11,11,127.0456957,37.54934695,22
진작카키,5,5,126.9871054,37.5794754,10
진저베어 파이샵,13,14,127.1053886,37.50909888,27
진저하우스,5,5,126.9612085,37.5251936,10
진접농협하나로마트 연평점,5,5,127.1862684,37.71108344,10
진접도서관,4,4,127.1941942,37.72960904,8
진주고속버스터미널,13,11,128.0930065,35.178698,24
진주성,4,4,128.0799814,35.18955476,8
진주시외버스터미널,4,4,128.0893767,35.19132007,8
진주집,4,4,126.9269602,37.5205985,8
진주회관,14,15,126.974502,37.56230759,29
진천종합터미널,5,5,127.4388871,36.85959371,10
진천토종순대국,3,3,126.6135337,37.23836626,6
집나온거북이,9,10,126.9909213,37.57390761,19
집한켠작은숲,5,5,127.1044698,37.48529511,10
짜장면박물관,24,26,126.618189,37.47483495,50
짬뽕김선생,5,5,127.1955152,37.05938071,10
짬뽕마스터 김포장기점,3,4,126.6597716,37.6495347,7
짬뽕지존 송파점,3,2,127.1114719,37.51033128,5
짬뽕지존 오산점,3,2,127.0659097,37.16536442,5
짬뽕지존 인천송도점,5,5,126.6451642,37.38577919,10
짬뽕킹,3,2,127.2112162,37.28748813,5
짬뽕타운 과천중앙점,4,4,126.9909501,37.42867446,8
짱구네 송도점,5,5,126.6463016,37.37031839,10
짱군떡볶이,4,4,127.024746,37.5060961,8
짱오락실 강남대로점,3,3,127.0252604,37.50199642,6
짱오락실 부천점,5,4,126.7811092,37.48575843,9
짱오락실 종로점,5,5,126.9870369,37.56980772,10
짱오락실 홍대점,5,5,126.9211271,37.55127561,10
째깍섬 한화용인센터,3,4,127.1447927,37.13157667,7
째리주택 행궁본점,5,5,127.0125396,37.28423935,10
쩡아네전집,3,3,126.7359531,37.40029432,6
쭈꾸미킹 광릉수목원점,5,5,127.1234823,37.77780513,10
쮸즈,5,5,127.0246192,37.51949676,10
찌깐한커피숍,4,4,127.5278682,37.46520864,8
찌마기 구의점,5,5,127.0892792,37.5394516,10
찜샤브 은평점,5,5,126.9178999,37.63753794,10
차니오뎅,5,5,127.0007359,37.58372879,10
차돌박힌쭈꾸미 명동점,4,4,126.9846561,37.56037941,8
차돌풍 방배역점,5,5,126.9961378,37.48202733,10
차만다 서울숲점,2,3,127.0414132,37.54660409,5
차만다 연남점,2,5,126.9245159,37.56193842,7
차만다 잠실점,4,4,127.1082995,37.51121181,8
차알 반포점,4,4,127.0063447,37.50398116,8
차알 용산점,5,5,126.9686915,37.52880073,10
차이797,3,3,128.4282006,36.0194201,6
차이나,4,4,126.8731351,37.62606299,8
차이나리,2,2,127.4176475,37.73399438,4
차이나타운 공영주차장,9,10,126.6183775,37.47599605,19
차이나타운 중화거리,5,5,127.7845121,37.92958055,10
차이나팬더,3,4,126.9906185,37.20622356,7
차이홍,4,4,126.6877417,37.7097751,8
차차커피코,5,5,126.7242421,37.49397368,10
차차티클럽 창신한옥,3,4,127.011365,37.57107828,7
차탄천주상절리,3,3,127.0574458,38.04675483,6
착한낙지 만안점,5,5,126.9275822,37.4200389,10
착한붕어 낚시카페,5,4,127.0026492,37.58295211,9
착한쭝식 광화문점,4,4,126.9742949,37.57202929,8
찬미네해물칼국수,4,4,127.5190641,37.86092198,8
찬빛광장,4,4,126.87187,37.4838158,8
찬우물한우정육식당,4,4,126.7803169,37.60250823,8
찰만생대패 이태원점,5,5,126.9933134,37.53385841,10
참나무집,7,7,127.510258,37.70351337,14
참도토리묵사발,4,4,127.1837073,37.47603523,8
참살이토속청국장,4,4,127.3253683,37.98231338,8
참치일번가,5,5,127.2138194,37.23380484,10
참토우식당 독산8호점,5,5,126.9022623,37.46960169,10
창경궁,153,154,126.9951999,37.57941654,307
창경궁 대온실,5,5,126.9939996,37.58301685,10
창덕궁,150,152,126.9911136,37.58004679,302
창덕궁 낙선재,3,3,126.9934611,37.57874612,6
창덕궁 돈화문,10,10,126.9899472,37.57785929,20
창덕궁 매표소,9,9,126.9901601,37.57761063,18
창덕궁 후원,30,30,126.9916177,37.5818274,60
창룡문,27,27,127.0251435,37.28779104,54
창룡문 ~ 동장대 (성곽길),4,4,127.1210246,35.84748755,8
창룡문주차장,5,5,127.026113,37.28685015,10
창릉천,13,11,126.8877089,37.63148744,24
창모루,19,19,127.233227,37.53929378,38
창산수목원,2,3,127.062278,38.063436,5
창성옥 용문본점,5,5,126.960413,37.53637477,10
창신골목시장,4,4,127.0120806,37.57254684,8
창신동 완구골목,5,5,127.0127162,37.5719106,10
창신육회 4호점,5,5,127.0007018,37.57070221,10
창우수산 활새우직판장 강남구청점,4,4,127.0401602,37.51654172,8
창원역,6,7,128.6065531,35.25750629,13
창원종합버스터미널,8,8,128.6393657,35.23633077,16
창원중앙역,19,18,128.7013074,35.24235021,37
창의문,3,3,126.9665112,37.59263125,6
창화당 익선동점,4,5,126.9898347,37.57294616,9
채널 트웰브,3,4,126.6188974,37.47381369,7
채록지펜션,3,4,127.353488,37.74517529,7
채선당M 송우점,3,4,127.1432859,37.82853914,7
채움카라반글램핑리조트 가평점,4,4,127.352257,37.88906482,8
채원막국수잣두부,11,11,127.3616249,37.76020749,22
책바,3,3,126.9303697,37.56686506,6
책발전소 광교점,13,12,127.0609039,37.27466882,25
책방791,5,5,126.9698873,37.57970201,10
책속에풍덩,4,5,127.619613,37.5451857,9
책속에풍덩 수영장,4,4,127.619613,37.5451857,8
책익다,5,5,126.9264009,37.55564705,10
책읽는고양이,4,4,127.0081056,37.57778015,8
책테마파크도서관,2,3,127.1479393,37.37830532,5
챔프커피 2작업실,3,3,126.9928134,37.53248165,6
챕터원 한남,3,3,127.004209,37.53737243,6
챠이나게이트,5,5,126.6195564,37.47895154,10
처핑,3,3,127.0332662,37.19250525,6
천계닭갈비,10,10,127.5124911,37.82937448,20
천궁전마라탕,3,3,126.9771376,37.56357222,6
천년셀프풍천장어직판장 직영7호점,4,4,126.9119376,37.4225241,8
천등고개,3,2,126.7633549,37.60401793,5
천마산 수진사입구분기점,5,5,127.2515044,37.67028873,10
천마정,5,5,127.1297051,37.64706455,10
천미가,5,5,127.364616,37.24665484,10
천미미,4,5,127.0203835,37.51733246,9
천상가옥,5,4,127.0569065,37.54140608,9
천상지애,3,4,127.4694866,37.83160422,7
천서리 막국수,5,5,126.3980766,33.40824823,10
천서리막국수촌,5,5,127.5479875,37.40307023,10
천수산풍천민물장어직판장,5,5,126.8235626,37.38432832,10
천안고속버스터미널,12,11,127.1544284,36.81925468,23
천안삼거리휴게소 서울방향,16,16,127.1736122,36.7875839,32
천안아산고속버스정류장,5,5,127.1075164,36.79375353,10
천안아산역,55,54,127.1043803,36.79460337,109
천안역,22,20,127.1469567,36.80908431,42
천안터미널,13,11,127.1563392,36.81973608,24
천안호두휴게소 부산방향,5,5,127.263867,36.73017542,10
천이코끼리주유소,4,4,126.9040218,37.40196569,8
천주교남한산성순교성지,11,11,126.9197666,36.09075752,22
천주교서울대교구 주교좌 명동대성당,112,118,126.9873561,37.56318453,230
천지불한증막사우나,3,3,127.4495289,37.28042746,6
천하무족,5,5,126.8099567,37.56007609,10
천하의문타로,4,4,126.9207654,37.55729403,8
철길부산집 구의점,5,5,127.085043,37.53954032,10
철길부산집 일산라페스타점,5,5,126.7659863,37.66341333,10
철도박물관,22,22,126.951311,37.31408675,44
철산공원,3,3,126.8711805,37.47181721,6
철산로데오거리,2,3,126.8686286,37.4752959,5
철산역 7호선,24,20,126.868211,37.47619284,44
철원막국수,10,10,127.3087493,38.14597542,20
철원역사문화공원,3,2,127.2000502,38.25498519,5
철원한탄강 주상절리길,12,11,127.2999132,38.17449925,23
철원한탄강 주상절리길 드르니매표소,5,5,127.2881401,38.15477736,10
철원한탄강 주상절리길 순담매표소,10,13,127.300111,38.17430415,23
철원해장국,4,4,126.7177667,37.77446046,8
첨성대,5,5,129.2190202,35.83471805,10
청계광장,28,28,126.9775921,37.56907469,56
청계사,8,9,127.0349003,37.41189991,17
청계산,12,13,127.0415086,37.42263611,25
청계산 골든밸리캠핑장,3,4,127.0782157,37.41603108,7
청계산 이수봉,3,4,127.0486358,37.41353131,7
청계산 화로구이,5,5,127.1946955,37.27750232,10
청계산등산로입구,9,9,127.0709255,37.42846612,18
청계산입구역 신분당선,10,10,127.0547203,37.44835474,20
청계산장글램핑,5,5,127.0464399,37.44830332,10
청계식당,4,4,127.1882242,37.7471822,8
청계중앙공원,5,5,127.1072427,37.19997255,10
청계천,223,226,126.9794642,37.56914027,449
청계천 장통교 진출입 계단 5번,5,5,126.9846193,37.56866496,10
"청계천,sfc몰(온센)",5,5,126.9786471,37.56914697,10
청계천로,4,4,127.0090103,37.56993062,8
청계천한빛광장,14,14,126.9850677,37.56804874,28
청계천헌책방거리,3,4,127.0058906,37.56944068,7
청관,3,3,126.6197232,37.47548862,6
청국장과보리밥 곤지암점,9,9,127.3443277,37.34945402,18
청기와,5,5,126.8449719,37.22362446,10
청기와타운,4,5,126.9732011,37.60747679,9
청기와타운 남영점,9,9,126.9725677,37.54370064,18
청기와타운 서울대점,5,5,126.9539619,37.48043084,10
청기와타운 을지로점,9,9,126.9836442,37.56588796,18
청남대만남의광장휴게소,5,5,127.525796,36.51260303,10
청년감자탕순대국 왕삽리역점,2,2,127.0405411,37.55993556,4
청년다방 건대점,3,3,127.0670983,37.54036278,6
청년다방 부평역점,5,5,126.7245826,37.49362299,10
청년다방 성남신흥역점,2,3,127.1481315,37.44156743,5
청년다방 인천삼산점,5,5,126.7322414,37.50852635,10
청년백범김구 역사거리,3,3,126.6257576,37.47214533,6
청담돈,5,4,127.037096,37.5236246,9
청담동마녀김밥,5,5,126.8883258,37.58151539,10
청담동명품거리,6,6,127.046048,37.52612624,12
청담집,2,2,127.0398684,37.52292722,4
청담추어정,4,4,126.8857115,37.27098281,8
청라셀프주유소,3,3,126.6403582,37.55640528,6
청라호수공원,13,13,126.6342799,37.53249043,26
청량리먹자골목,2,3,127.0450234,37.5810689,5
청량리역,44,44,127.0485548,37.58080494,88
청량리역 1호선,3,3,127.0447272,37.58003706,6
청량리역 경춘선,17,18,127.0486361,37.58127348,35
청량리전통시장,3,4,127.0436045,37.58061952,7
청량산,4,3,126.6611135,37.41919693,7
청려원 동물건강증진센터,5,5,127.0160221,37.2751114,10
청룡각,4,4,127.0076455,37.50621558,8
청마루 손칼국수전문점,4,4,126.766799,37.50477469,8
청명역 수인분당선,8,8,127.078969,37.25953957,16
청명역 수인분당선 1번출구,4,4,127.0800271,37.26020023,8
청목장어,5,5,127.3226819,37.54158619,10
청목한정식,1,2,127.4085995,37.29961822,3
청산명가(청산별미),14,14,127.1506267,37.95496865,28
청산시골쌈밥,4,4,127.0135551,37.28752623,8
청산어죽,13,14,126.6958569,37.71422775,27
청산짜장,5,5,127.1097116,38.03165063,10
청송옥,2,2,126.9730607,37.56344432,4
청수당,1,2,126.9897847,37.57388048,3
청수당 해림,15,15,127.058097,37.28418611,30
청수장계곡,4,4,126.9992117,37.61677533,8
청수정,4,4,126.9817043,37.58359583,8
청시행강릉수제버거 남양주점,9,9,127.1739327,37.58612523,18
청실홍실 신포본점,5,5,126.6250134,37.47086084,10
청어람 망원점,4,4,126.9074696,37.55810517,8
청와대,10,10,126.974811,37.5866076,20
청와대  본관 영빈관등,4,5,126.9739822,37.5848966,9
청와대 대통령관저,6,8,126.9773105,37.58705128,14
청와대 본관,197,222,126.9748537,37.58657325,419
청와대 영빈관,13,15,126.9739486,37.58480711,28
청와대 정문,38,48,126.9752405,37.5843677,86
청와대 춘추관,14,14,126.9789643,37.58405127,28
청와대 춘추문,7,9,126.9791694,37.58375579,16
청와옥 석촌호수직영점,5,5,127.097459,37.5057035,10
청와옥 을지로3가 직영점,25,25,126.9900507,37.56601482,50
청와정,5,5,127.0554691,37.67217641,10
청와정 카페&펜션,7,7,127.1844811,37.47989575,14
청운닭갈비막국수,9,9,127.5148014,37.81660338,18
청운문학도서관,24,25,126.9659053,37.59040383,49
청운숯불갈비,5,5,126.9684704,37.55415571,10
청운중학교,5,5,126.9711096,37.5892123,10
청이네 청도미나리삼겹살,2,3,126.7121648,37.70568965,5
청일조계지경계계단,7,7,126.6200491,37.47408049,14
청정옥,5,5,127.0487715,37.54587688,10
청주고속버스임시터미널,28,25,127.429371,36.62662377,53
청주국제공항,4,4,127.4958529,36.72202246,8
청주북부터미널,24,24,127.4272531,36.71173817,48
청주시외버스터미널,22,20,127.4317027,36.62533844,42
청주여객터미널 북부정류장,15,14,127.4869815,36.65045424,29
청주한씨문정공파묘역신도비,4,4,127.1475047,37.38011151,8
청진동해장국 본점,3,3,126.9170225,37.41531062,6
청진옥,3,3,126.9794489,37.57171765,6
청진옥 본점,5,6,126.9794489,37.57171765,11
청초수물회 속초본점,4,4,128.59054,38.19214712,8
청초수물회섭국 백운호수점,4,4,127.0026893,37.37559022,8
청초호물회을왕리점,5,5,126.4145317,37.4488479,10
청춘등판,5,5,127.0661244,37.54198963,10
청춘쉼미당,3,3,126.9193123,37.35414443,6
청춘이면 재인폭포점,6,7,127.0783238,38.07673079,13
청춘이면 전곡점,5,5,127.0653679,38.02468797,10
청춘조개 별관,2,1,126.6868563,37.34239283,3
청춘조개 본점,8,8,126.6870974,37.343035,16
청춘조개 월미도직영점,16,16,126.5981705,37.47640839,32
청춘한복아랑,10,9,126.970837,37.57995003,19
청춘호텔,3,3,126.6872732,37.45941812,6
청키면가 무교점,5,6,126.9811331,37.56799051,11
청평5일시장,8,9,127.4159012,37.73473754,17
청평K 숯불닭갈비막국수,5,5,127.3490524,37.81846528,10
청평돌짜장,15,15,127.3938251,37.69835571,30
청평물소리펜션,4,4,127.4632996,37.72344911,8
청평보이네닭갈비,5,5,127.4204053,37.73299081,10
청평사,5,5,127.8091004,37.98658965,10
청평역 경춘선,54,54,127.4266229,37.7355164,108
청평역 관광안내소,3,3,127.4266502,37.73553432,6
청평연돈까스,5,5,127.419699,37.73727651,10
청평자연휴양림,31,31,127.4084674,37.71081495,62
청평터미널,5,5,127.4208564,37.73811749,10
청평파인호텔,5,5,127.4263226,37.73380565,10
청평페리,10,10,127.4819978,37.71061116,20
청평하나휴게소,5,5,127.4475648,37.76712373,10
청평호,13,13,127.4846643,37.7066522,26
청평호반닭갈비 수원점,5,5,126.9534454,37.27378781,10
청평호반닭갈비막국수,21,21,127.417218,37.73426709,42
청학동계곡,4,4,127.0949182,37.6995698,8
청학동칼국수,9,9,127.0152598,37.28004469,18
청화우육도삭면,1,2,126.979851,37.57083024,3
청화원,7,7,126.9685437,37.57026867,14
체다앤올리,5,5,127.0424005,37.54572617,10
체리모텔,6,6,127.1083347,37.51524827,12
체부동잔치집,4,5,126.9714677,37.5765228,9
체스터톤스속초,20,20,128.5805325,38.19417581,40
체스호텔 인덕원역점,5,5,126.9761474,37.39956948,10
초가,5,5,127.1852797,37.47732122,10
초가집,4,4,126.8224789,37.19411415,8
초당옥도나스,9,9,126.6885261,37.34701951,18
초당옥수수커피,3,3,128.908089,37.78723927,6
초량전통시장,4,4,129.0399222,35.11819027,8
초록미소마을,5,5,126.3280006,34.40071619,10
초록향기 농부의밥상,5,5,127.3091302,37.5589639,10
초류향,3,4,127.3516636,38.01316829,7
초막골생태공원,5,5,126.9186078,37.34910089,10
초성리역,4,4,127.0684311,37.98129118,8
초시매,5,5,127.4395097,37.61473152,10
초심삼겹살,4,4,126.8277656,37.56843491,8
초안,20,21,127.017749,37.28263483,41
초원,5,5,126.9733409,37.54264935,10
초원닭갈비막국수,15,15,127.5150415,37.81389588,30
초원의집,4,4,127.1557473,37.46203585,8
초이댄스 스튜디오,4,4,127.1124557,37.28039322,8
초이라멘,5,5,127.0085521,37.57148307,10
초장집 압구정로데오점,5,4,127.0394601,37.52739363,9
초평가배,3,3,126.9436976,37.31228491,6
촌놈집 인계점,5,2,127.0350745,37.26433984,7
촌집,4,4,127.0687568,36.99701953,8
촛불1978,4,4,126.985337,37.55681155,8
총각네붕어빵,3,3,127.0013674,37.56982644,6
총신대입구역 4호선,4,4,126.9822119,37.4867996,8
최고당돈가스 동탄센트럴파크점,4,4,127.0646892,37.20768399,8
최고봉갈매기살 전대리점,5,5,127.2167057,37.28622937,10
최고집원조수구레,4,4,126.9700669,37.2968012,8
최고집칼국수,5,5,127.1600914,37.60665496,10
최미삼순대국 고색점,10,10,126.9742017,37.24374437,20
최영화빵,4,5,129.2153516,35.84150575,9
최우영식당 홍대점,5,5,126.9207047,37.55691918,10
최정규의 팔당원조칼제비보쌈 곤지암점,4,4,127.3540772,37.35002172,8
추억닭발 인천본점,5,5,126.7214914,37.49414202,10
추억의역전집,3,4,127.2965133,37.52331589,7
추억의청춘뮤지엄,3,4,127.5853401,37.54458573,7
추카추카,3,3,127.0516995,37.07892342,6
축령산,4,4,127.3339612,37.75270302,8
축령산계곡가든,5,5,127.3088235,37.75268148,10
축령산자연휴양림,4,4,127.313144,37.75471707,8
축령산자연휴양림 매표소,4,4,127.3105244,37.75348067,8
축석주유소,4,4,127.0916687,37.76417195,8
춘리마라탕 연남동점,5,5,126.924167,37.56217967,10
춘원이광수기념비,2,2,127.185573,37.74691431,4
춘천 샤크아일랜드펜션,3,2,127.5266746,37.82723613,5
춘천골닭갈비,3,3,127.0374353,37.20527732,6
춘천꼬꼬닭갈비 청평점,3,3,127.4227827,37.73770696,6
춘천닭갈비,5,5,127.199516,37.23526066,10
춘천막국수,2,2,127.7238743,37.89224745,4
춘천삼악산호수케이블카,16,19,127.4001576,36.77760553,35
춘천시외버스터미널,24,21,127.7186239,37.86318497,45
춘천식당,3,3,126.9615775,37.52483513,6
춘천에서온숯닭,5,5,127.042191,37.29770481,10
춘천역 경춘선,10,10,127.7166986,37.88451274,20
춘천장인닭갈비 목동점,4,4,127.1257013,37.18036912,8
춘천정통닭갈비,2,3,126.7058949,37.72777317,5
춘천중도물레길,4,5,127.6899443,37.87083787,9
춘향골,5,5,127.127112,37.43015982,10
춘향미엔,5,5,127.0320212,37.56046977,10
충남대학교 정심화국제문화회관 정심화홀,5,5,127.3461254,36.36287002,10
충남집순대,5,5,127.2989912,36.76217936,10
충목단,5,5,127.1440427,37.81117138,10
충무로역 3호선,15,14,126.9941507,37.56139658,29
충무로역 4호선,10,10,126.9952554,37.56151196,20
충무로쭈꾸미불고기 본점,6,7,126.9922028,37.56173615,13
충무아트센터,5,5,127.0148097,37.56601611,10
충무아트센터 대극장,20,20,127.0148097,37.56602692,40
충장근린체육공원 테니스장,5,5,126.8261033,37.61347933,10
충정로역 5호선,4,4,126.9630396,37.56042868,8
충주공용버스터미널,5,4,127.9148855,36.98204148,9
충주봉방작은도서관,5,5,127.9171855,36.97791132,10
충주휴게소 양평방향,3,3,127.8392518,37.02324147,6
충주휴게소주유소 양평방향,3,3,127.8374554,37.02410926,6
충주휴게소주유소 창원방향,17,17,127.8392045,37.02098917,34
충청도7호,3,4,126.6016035,37.45200906,7
충헌공김구선생묘,1,1,127.1242793,37.5238624,2
충현박물관,2,4,126.8782153,37.43356406,6
충현역사공원,3,4,126.878755,37.43238969,7
츄로101 삼청점,3,3,126.9818309,37.58431664,6
츄로바,4,4,126.6963946,37.78861096,8
츠케루,5,5,126.9244815,37.55334019,10
치르치르&뉴욕야시장 명동본점,5,5,126.9836195,37.56484821,10
치뽈라,5,5,126.9852705,37.49798602,10
치앙마이방콕,5,5,126.9899477,37.5737904,10
치어스 정자수성점,3,3,127.0048991,37.29196722,6
치유의숲,4,4,127.0450425,37.73470851,8
치읓시옷디귿,5,5,126.8644294,37.47429644,10
치즈룸,5,5,127.0288589,37.52531358,10
치즈룸 테이스팅룸 롯데월드몰점,8,9,127.103772,37.5137549,17
치즈스마일스튜디오,9,9,126.9866356,37.57942219,18
치카이라멘 옥수본점,5,5,127.0153662,37.54228195,10
칙바이칙 선릉역점,5,5,127.0477956,37.50620255,10
친구 서울 자취방,5,5,126.5821867,33.26047394,10
친구 집 가는길,3,3,126.7786436,33.40269826,6
친구집,3,1,126.244325,33.35413025,4
칠곡(부산방향)휴게소,3,3,128.4282006,36.0194201,6
칠곡저수지,11,11,127.1542017,37.04757627,22
칠곡휴게소 서울방향,9,10,128.4309022,36.01203096,19
칠궁,2,2,126.973276,37.58506194,4
칠보산,4,4,126.9320505,37.26055017,8
칠서휴게소 양평방향,6,6,128.4967709,35.37090525,12
칠오닭갈비,6,6,127.4930226,37.71495057,12
칠오닭갈비 본점,7,6,127.3687315,37.76894281,13
칠오닭갈비 신관,9,9,127.3689396,37.76901874,18
칠홉스 브루잉코 이태원 프로젝트,5,5,126.9884482,37.53495726,10
칭찐,5,5,126.7492565,37.67054263,10
카나비스트릿,5,5,127.0445461,37.54970779,10
카라솔,5,5,127.0738279,38.09631241,10
카렌,3,3,127.0985621,37.51206367,6
카루소,4,4,126.9349023,33.46461844,8
카리스호텔,6,6,126.9808806,37.4752052,12
카린지,5,5,127.0459741,37.54576087,10
카린지 성수점,4,4,127.0459628,37.54574826,8
카메라타,14,14,126.6996042,37.78997783,28
카멜로연남,4,4,126.9263613,37.56134854,8
카멜커피 더현대서울점,5,5,126.9284495,37.52585766,10
카멜커피 도산2호점,7,7,127.0345944,37.52516788,14
카멜커피 도산공원점,4,4,127.0359851,37.52344655,8
카멜펜션,2,3,127.4133259,37.96897734,5
카몽,5,5,127.0089376,37.49120833,10
카무플라주,3,4,126.9935702,37.53363318,7
카미야,4,5,126.9223638,37.55258288,9
카이센동우니도 신사본점,5,5,127.0198923,37.52062571,10
카이정헤어 서교점,5,5,126.9186643,37.55256237,10
카자구루마,55,61,127.0115472,37.28371685,116
카제,5,5,126.8102532,37.56274712,10
카츠8 용산점,2,2,126.9643569,37.52992486,4
카츠랑 천왕역점,5,5,126.8394897,37.48624681,10
카츠바이콘반,2,2,127.0364608,37.52479791,4
카츠소라,5,5,127.4448524,37.2790323,10
카츠온반,5,5,126.7691096,37.6602138,10
카츠이산,1,1,127.0126187,37.28533861,2
카카오스크린골프&펍 위례점,4,4,127.1426572,37.47344115,8
카카오판교아지트,2,2,127.1103642,37.39541713,4
카카오프렌즈 강남플래그십스토어,17,18,127.0258119,37.50089347,35
카카오프렌즈 스타필드 코엑스몰점,3,3,127.0590287,37.51207563,6
카카오프렌즈 용산역 팝업스토어,4,4,126.9645776,37.5298168,8
카카오프렌즈 판교아지트점,5,5,127.1101128,37.39569668,10
카카오프렌즈 홍대플래그십스토어,18,20,126.9239195,37.55631943,38
카키,2,2,127.0173803,37.56613109,4
카키바움,2,2,126.9727384,37.53177955,4
카페 395,5,5,126.975498,37.55545301,10
카페 눈,5,5,127.1025207,37.54168884,10
카페 들,5,5,127.2086754,37.46514382,10
카페 락가든,1,2,126.6990824,37.71394862,3
카페 레이어드 안국점,9,9,126.9859352,37.57771472,18
카페 루버월,5,5,126.7050346,37.71931993,10
카페 리퍼크,5,5,127.0286286,37.49704733,10
카페 마당,5,5,126.6946291,37.71245778,10
카페 메이플림,5,5,127.3384125,37.59341586,10
카페 뷰66 미호점,4,4,127.1760912,37.58732215,8
카페 손수다,4,4,126.9151828,37.42693065,8
카페 얼트,5,5,126.5824626,37.49150158,10
카페 연무장,5,5,127.0533093,37.54286738,10
카페 오로지,3,4,127.1839031,37.47841179,7
카페 와안,3,3,126.18457,33.35101138,6
카페 이노스,9,8,126.6289612,37.40603929,17
카페 인 병점,3,3,127.0352857,37.20713955,6
카페 채터,4,4,127.6729835,37.54284294,8
카페 탄지리,4,4,128.0904178,36.92248388,8
카페 품,5,5,127.1560532,37.6847864,10
카페 프로방스,4,4,127.3005059,38.18572293,8
카페 하이웨스트 익선점,9,9,126.9906723,37.57312372,18
카페 하이웨이스트 익선점,5,5,126.9906723,37.57312372,10
카페&펍 탄,5,5,127.0696283,38.00996888,10
카페109하우스,4,4,126.4000818,37.67912743,8
카페1155,4,4,126.7511901,37.50526182,8
카페256,4,4,126.9941572,37.59486672,8
카페365,3,3,126.9472734,37.53816442,6
카페58.4,4,4,127.0011097,37.59368475,8
카페65도씨 인천시청점,4,4,126.7036104,37.45079971,8
카페8794,4,4,126.7737916,37.88069661,8
카페8794 용인점,2,4,127.2065622,37.1346028,6
카페COC,5,5,126.9180854,37.55518387,10
카페감자밭 본점,8,8,127.7845121,37.92958055,16
카페골목숲,7,7,126.9820667,37.58321026,14
카페공명,4,4,126.9263526,37.5598709,8
카페관동,5,5,126.623101,37.47281805,10
카페구움,5,5,126.8962648,37.46099012,10
카페그루비,9,9,127.0359968,37.28908639,18
카페기차가있는풍경,4,5,127.0930918,37.62445107,9
카페꼼마 송도점,10,10,126.6339657,37.39796016,20
카페나무,4,4,126.925365,37.55259382,8
카페나울,5,5,126.6568787,37.69308309,10
카페노을,4,4,126.6183384,37.16245066,8
카페노티드 강남카카오점,5,5,127.0257711,37.50079257,10
카페노티드 삼성,15,15,127.0638929,37.51004584,30
카페노티드 성수,8,9,127.0526852,37.54361369,17
카페노티드 안국,31,32,126.9860303,37.57745705,63
카페노티드 여의도IFC점,10,10,126.924872,37.52517608,20
카페노티드 잠실,12,13,127.1106489,37.50904722,25
카페노티드 종각하이커,10,10,126.9816174,37.56852758,20
카페노티드 청담,5,5,127.0382366,37.52418466,10
카페노티드 피치스,5,5,127.051328,37.54465945,10
카페노티드 한남점,4,4,127.0008486,37.53483168,8
카페다람,4,4,126.7612564,37.51109767,8
카페다빈치,4,4,126.5968173,37.47324666,8
카페다오,4,4,127.0025361,37.58420629,8
카페다이브,3,3,126.6328109,37.53996954,6
카페달콩,2,3,127.1695419,37.00006494,5
카페대너리스,1,1,127.3389946,37.59742538,2
카페더그레이트,4,4,127.0002489,37.53691299,8
카페더스페이스,5,5,126.9238705,37.41959958,10
카페도담도담,4,4,127.1871625,37.97200872,8
카페동네 서운점,3,4,126.7448069,37.53713641,7
카페드까사,5,5,127.3720578,37.68974824,10
카페드첼시,10,10,126.5768627,37.69155005,20
카페디스튜디오S,4,4,127.3097853,37.320431,8
카페디썸,3,3,126.748262,37.67100181,6
카페디아망,5,5,127.1843387,37.87441343,10
카페디아즈,5,5,127.0343507,37.2642049,10
카페라플렌 별내점,3,3,127.1029159,37.70046047,6
카페랑솜,3,3,127.0004302,37.58233225,6
카페럭,5,5,127.0582999,37.28406347,10
카페로마,5,5,127.0377127,37.52616163,10
카페로스안데스,8,8,127.0241823,37.28663431,16
카페로아,7,8,126.6868751,37.34250957,15
카페로쥬,5,5,127.1125151,37.39735591,10
카페루헤,5,5,126.5685357,37.28231837,10
카페리빈 갤러리아포레점,3,4,126.9239195,37.55631943,7
카페마당,2,2,127.6775579,37.32283769,4
카페마마스 강남역점,5,5,127.0254551,37.4960182,10
카페마마스 압구정점,5,5,127.0400987,37.52847462,10
카페마마스 잠실점,4,4,127.1006103,37.51442618,8
카페만경,4,4,127.3159504,37.53352245,8
카페메이븐,5,5,127.0231217,37.28465944,10
카페모굴,3,3,127.4235745,37.73331462,6
카페모니터,4,4,126.6422548,37.38328992,8
카페모종,9,9,127.012542,37.28547017,18
카페모차르트502,9,9,127.0121955,37.47844795,18
카페모테이,4,4,127.0000903,37.37709136,8
카페목련,5,5,127.4981092,37.83860511,10
카페무르,3,4,127.4267594,37.50412948,7
카페문,2,3,126.8976404,37.62569756,5
카페미뇽 대학로점,5,5,127.0006114,37.5832873,10
카페바다쏭 인천연수점,12,12,126.636149,37.42942131,24
카페반월,5,5,127.0551223,37.22555123,10
카페베네 서울랜드점,4,4,127.0171834,37.43311828,8
카페베네 선릉역점,3,3,127.0508217,37.50547418,6
카페베네 소래포구점,4,4,126.7361536,37.39946673,8
카페베네 일산킨텍스점,3,3,126.7442892,37.66867234,6
카페별산대,10,10,127.0318229,37.78555615,20
카페봄,3,4,127.3286791,37.54573315,7
카페봄날,2,2,127.0326417,37.74766853,4
카페브리끄,3,4,127.3733202,37.65886605,7
카페비니 아치울점,5,5,127.1200616,37.57412621,10
카페빙빙 배곧점,5,5,126.7254314,37.36938246,10
카페빵선생 소래포구점,5,5,126.7354821,37.40028516,10
카페쁘라제르,7,7,127.3880647,37.7024526,14
카페산책,4,4,126.7453253,37.50248144,8
카페설리번,4,4,126.9025728,37.53520595,8
카페세마,5,5,127.0671108,37.64011702,10
카페소비,2,3,126.7839342,37.67127797,5
카페솔트,3,3,126.8941733,37.51340078,6
카페수달,4,4,126.9844342,37.57667479,8
카페숨,7,7,127.1636538,37.78802805,14
카페쉼표,2,4,127.0809423,37.78983204,6
카페스퀘어드,3,3,127.0148489,37.28371287,6
카페스티빈,2,3,127.0703529,37.17555552,5
카페시그니처,4,4,127.0359888,37.50766096,8
카페시차,4,4,126.5739064,37.67797708,8
카페신복리709,4,4,127.4740915,37.53338992,8
카페아리,5,5,127.1557314,37.82456634,10
카페아쁠뤼스,4,4,127.4069387,37.72823773,8
카페아우라,8,9,127.449698,37.7077782,17
카페아키라,5,5,126.6187539,37.47623964,10
카페애몽,5,5,126.949734,37.66315813,10
카페애플트리,3,4,126.869896,37.96037712,7
카페앤,2,3,127.5254325,37.80327645,5
카페어니언 광장시장점,4,4,127.0015042,37.5697865,8
카페어슬러,3,3,127.3333206,37.54898985,6
카페언트,3,3,126.9914896,37.45412818,6
카페엔소파,3,3,127.2496198,37.38828713,6
카페엘,4,4,127.1505423,37.37462585,8
카페엘리에나,4,3,127.0314662,37.51119689,7
카페엘림,4,5,127.3118495,37.33508712,9
카페여주,10,10,127.7191806,37.26437721,20
카페예체르,3,3,127.267891,37.40875074,6
카페오라,4,4,126.3736088,37.45206212,8
카페오르골,5,5,127.3830965,37.29309175,10
카페오색칠,3,3,127.0558592,37.542049,6
카페오시,4,4,126.6838528,37.70817409,8
카페오즈,4,4,126.6198304,37.47841903,8
카페온,5,5,126.9905591,37.57312371,10
카페온더데스크,4,4,127.1281726,37.38553658,8
카페올두바이,5,5,126.9580361,37.51766374,10
카페올랄라,2,2,127.1621156,37.50967706,4
카페웨더,10,10,127.22853,37.53515477,20
카페윈썸,4,3,127.3489487,37.82056301,7
카페율하온 진해이동점,5,4,128.6973759,35.1549285,9
카페은하수,4,4,127.2775084,38.19976506,8
카페이마,3,4,126.97761,37.56973062,7
카페이음,9,10,127.016853,37.28496505,19
카페인 중리,5,5,127.1405715,37.20583957,10
카페일월삼일,3,3,127.128379,37.65804267,6
카페자호,4,4,126.8602723,37.45316109,8
카페정덕,3,3,127.0206809,37.28295873,6
카페제부리,10,10,126.6173615,37.17063176,20
카페조각,2,2,126.9544597,37.39043757,4
카페준,4,4,126.7524083,37.67235124,8
카페지미스,5,5,126.7822348,37.66945848,10
카페진리,3,4,127.4546655,37.26680945,7
카페진선,3,5,126.9804686,37.58138279,8
카페체리쉬영,5,5,127.3047745,37.33901782,10
카페초희,3,3,126.6188565,37.47517408,6
카페키츠네 서울,5,5,127.0227641,37.51963859,10
카페톤,5,5,127.2622605,37.31376471,10
카페파리,18,19,127.4614479,37.77634644,37
카페파즈,3,3,127.1135801,37.66301775,6
카페팜트리,5,5,126.6796325,37.64133012,10
카페퍼르,3,4,127.2096244,37.82702165,7
카페퍼즈,4,4,127.0886914,36.99390298,8
카페페퍼,5,4,127.1101408,37.50962434,9
카페포러데이 삼패점,5,4,127.1928496,37.59321367,9
카페포제,6,6,127.0557512,37.54293653,12
카페피크닉,4,4,126.9781208,37.55697612,8
카페피포에스,5,5,126.994213,37.57610804,10
카페하날,3,4,127.6025162,37.49665316,7
카페하이웨스트 판교점,5,5,127.1119569,37.39261706,10
카페하이웨스트 현대백화점 판교점,5,5,127.1119894,37.3926596,10
카페해오름,5,5,127.2464779,37.10925175,10
카페헤이디,3,3,127.0889649,37.18204592,6
카페혜화동,9,8,126.9999138,37.58190338,17
카페호미,3,3,126.9797948,37.57790124,6
카페화소가,4,4,126.7141251,37.54460206,8
카페화홍,4,4,127.0173484,37.28646251,8
카페희다 일산웨스턴돔점,4,4,126.7713261,37.65660428,8
카펜트리,5,5,127.2085357,37.71448427,10
카포레,4,4,127.4353838,37.50545401,8
칸다소바 경복궁점,9,10,126.9712633,37.57817697,19
칸다소바 혜화점,4,3,127.0013722,37.58288455,7
칸지고고 죽전점,2,3,127.1082934,37.32656617,5
칸타타노래연습장,4,4,127.4438795,37.28079837,8
칸트의마을,5,5,127.3999602,37.49223274,10
칼리오페,5,7,127.1928277,37.24810441,12
칼봉산자연휴양림,5,5,127.4648149,37.83727358,10
칼봉산자연휴양림 산림문화휴양관,5,5,127.465868,37.83491615,10
칼뽕 포천점,7,8,127.1612228,37.84682333,15
칼튼호텔,7,8,126.8525458,37.55461565,15
캐나다 전투기념비,4,4,127.5300558,37.87687371,8
캐리비안베이,61,62,127.2009876,37.29710918,123
캐슬602,2,2,126.8250859,37.60250379,4
캐슬모텔,2,2,126.8586102,37.4787334,4
캐치,4,4,126.9717588,37.5792709,8
캐치스톤클라이밍짐,5,5,126.7822993,37.48557141,10
캔모아 용인점,5,5,127.2074948,37.23571549,10
캘리소프트서브 수원점,9,10,127.0109914,37.28479094,19
캠퍼스타운역 인천1호선,4,4,126.6622061,37.38844296,8
캠프99,4,4,127.3692896,37.90151587,8
캠프게이트카라반,2,3,127.4874784,37.71245003,5
캠프월드레저,5,5,127.5524897,37.84024012,10
캠프통포레스트,14,14,127.4922185,37.70278639,28
캠핑고래 서울은평점,4,4,126.9126032,37.58821041,8
캠핑고래 이천점,5,5,127.4665236,37.29298334,10
캠핑고래 평택안성점,5,5,127.1373992,36.98585497,10
캠핑꾸러미,4,6,127.3410982,37.69151136,10
캠핑사이다 가평 은빛물결점,5,5,127.3666039,37.80235697,10
캠핑소리251,8,10,127.5113621,37.64102808,18
캡슐마중게스트하우스,2,2,126.9056025,37.51565847,4
커넥츠커피 망원점,5,5,126.9105122,37.55490447,10
커넥츠커피 에스프레소바 역촌역점,4,4,126.9248854,37.60763522,8
커먼그라운드,11,11,127.0656687,37.54105555,22
커스텀커피 더하우스,12,13,127.1946955,37.27750232,25
커스텀커피 송도타임스페이스점,4,4,126.64278,37.38326268,8
커트매니아,5,5,126.9236042,37.49257692,10
커푸,5,5,126.692441,37.34774877,10
커피가이,5,5,127.0198466,37.28344543,10
커피공장,5,5,127.0113715,37.55467474,10
커피공장103 헤이리점,3,3,126.697674,37.79169193,6
커피기업 광화문점,4,4,126.981107,37.57266307,8
커피나무숲,3,3,127.0193945,37.01473149,6
커피나인,4,4,126.9872373,37.53632665,8
커피다동로스터스,4,4,126.9805253,37.5677093,8
커피라이트,3,3,126.5632316,33.25015006,6
커피루소 정동점,5,5,126.9706077,37.56703961,10
커피리브레 강남 신세계파미에스트리트점,4,4,127.0043339,37.5053688,8
커피리얼리스트,5,5,127.4975106,37.49443726,10
커피마을,5,5,127.0438942,36.95885052,10
커피말리,5,5,128.5798561,38.19488215,10
커피맥아더,1,2,126.8231985,37.60614818,3
커피먹는호랑이,4,4,127.4899565,37.67127631,8
커피바이 (잠실2호점),4,4,127.0852648,37.5104167,8
커피바이 준천재,3,3,127.0861436,37.50870723,6
커피반점,4,4,127.0612635,37.27308731,8
커피베이 방화역점,3,3,126.8126858,37.57668037,6
커피비노,5,5,126.7314034,37.50598974,10
커피빈 강남대로센터점,3,3,127.0260746,37.50191695,6
커피빈 강동경희대병원앞점,4,4,127.1560372,37.55249989,8
커피빈 김포장기DT점,5,4,126.6776343,37.63649722,9
커피빈 명동거리점,7,7,126.9856937,37.56148236,14
커피빈 몽촌토성역점,3,4,127.1127848,37.51692087,7
커피빈 용인에버랜드점,5,5,127.2008457,37.29042734,10
커피빈 종로관철동점,8,8,126.9867745,37.5685535,16
커피빈 현대프리미엄아울렛김포점,8,8,126.7856729,37.59675896,16
커피빈 혜화역점,5,4,127.0011548,37.58352156,9
커피스톤,4,4,127.1117321,37.38421614,8
커피앤시가렛,4,5,126.9740853,37.5626697,9
커피에반하다 삼청점 스마트카페,5,5,126.9819899,37.58230565,10
커피온더레일,7,6,126.9505373,37.31041021,13
커피온리 종로3가점,3,3,126.9895995,37.56993771,6
커피커퍼박물관,5,5,128.9157802,37.79400041,10
커피투어,2,2,126.9714103,37.57288997,4
커피투어 경복궁점,3,3,126.9722738,37.57632477,6
커피팩토리글로보,4,4,126.9818998,37.58029822,8
커피하겐나,10,10,126.5730457,37.28639838,20
커피한약방,9,9,126.9886017,37.56656429,18
커피한약방 혜화점,3,3,127.0048126,37.58085633,6
커피화,5,5,126.6672244,37.38613796,10
커핀그루나루 올림픽공원역점,3,3,127.1293783,37.51663987,6
컨디션마사지,4,1,126.985413,37.56152557,5
컨플릭트스토어 잠실점,9,9,127.1063578,37.51386252,18
컬러라이즈 강남점,4,5,127.0285546,37.49279459,9
컴오프,3,3,127.0429334,37.54741084,6
컴컴PC방,5,5,126.7253645,37.49379429,10
컴포즈커피 과천렉스타운점,4,4,126.9924675,37.42816009,8
컴포즈커피 광진아차산점,3,3,127.0934013,37.55310305,6
컴포즈커피 덕성여대점,5,5,127.0131789,37.65099583,10
컴포즈커피 동탄남광장점,4,4,127.0716089,37.20109873,8
컴포즈커피 발산점,4,4,126.8383837,37.55768754,8
컴포즈커피 범계역점,5,5,126.9522195,37.39006907,10
컴포즈커피 송내역점,4,4,126.7525624,37.48901329,8
컴포즈커피 송파사거리점,5,5,127.1083421,37.501553,10
컴포즈커피 수원역점,4,4,127.0015332,37.26567857,8
컴포즈커피 순천역점,10,8,127.5026332,34.94508798,18
컴포즈커피 양천신곡점,8,8,126.8424733,37.51815901,16
컴포즈커피 용인둔전점,5,5,127.2178696,37.26987249,10
컴포즈커피 은평응암오거리점,4,4,126.9166203,37.59030362,8
컴포즈커피 인천소래포구점,3,3,126.7363581,37.39913381,6
컴포즈커피 인천차이나타운점,2,2,126.617549,37.47574559,4
컴포즈커피 충무로점,3,3,126.9961502,37.561238,6
컴프에비뉴,3,4,126.6972672,37.79177737,7
컵오브커피 차이나타운점,3,3,126.6187998,37.47565864,6
케르반카페,3,4,126.9965651,37.53326749,7
케이스파,3,3,127.0377314,37.52722481,6
케이스포돔 올림픽체조경기장,28,28,127.1274078,37.51924411,56
케이슨24,9,9,126.6302889,37.37119747,18
케이투원투,3,3,126.9917908,37.53130668,6
케이팝코인노래연습장,5,5,126.9834387,37.56344624,10
케이팝하우스,2,2,126.9771657,37.55678862,4
케이팝호텔,15,15,127.5001365,37.81429436,30
케이힐스더테라스,13,13,126.7614994,37.71647718,26
케팝코인노래연습장 웨스턴돔점,5,5,126.771877,37.65691529,10
켄싱턴리조트 가평,11,10,127.3956253,37.75969733,21
켄싱턴호텔 여의도,30,31,126.9219289,37.53026123,61
켄싱턴호텔 여의도 더뷰라운지,5,5,126.9219932,37.53027478,10
켄싱턴호텔 여의도 브로드웨이,5,5,126.9219593,37.53027206,10
켄커피 본점,5,5,126.9241624,37.41907807,10
코끼리베이글,9,9,126.8934507,37.52923345,18
코끼리베이글 2호점,5,5,127.0015838,37.52438005,10
코끼리즉석떡볶이,4,4,126.9488288,37.5403167,8
코너갤러리,5,5,126.9839423,37.57948132,10
코다리밥도둑,5,5,126.9548732,37.67172312,10
코드케이 인천구월점,4,4,126.701679,37.4442391,8
코드케이 홍대점,1,4,126.9232874,37.55024269,5
코리달리스카페,15,16,127.4819695,37.71096536,31
코리아 주얼랜드,5,5,126.9929048,37.57072002,10
코리아게스트하우스,10,10,126.9820534,37.5821579,20
코리아나호텔,29,32,126.9766348,37.56813117,61
코리아마트,4,3,126.9863513,37.56167164,7
코마린 이스트보트하우스 송도지점,13,14,126.6435695,37.39036328,27
코메야쌀국수,5,5,126.7708932,37.65991454,10
코미호미카페,14,15,127.5108051,37.74223979,29
코믹존,4,4,126.9303091,37.48114007,8
코바코 평택오성점,4,4,126.3280006,34.40071619,8
코버월드,4,5,127.2132885,37.89949281,9
코베아 계양직영매장,2,2,126.7590118,37.5263867,4
코벤트가든 올림픽공원점,4,4,127.1258531,37.51223236,8
코보스호텔,6,6,126.920673,37.5301829,12
코스 한남점,5,5,127.0009776,37.53775452,10
코스트코 공세점,2,2,127.1088387,37.23828368,4
코스트코 광명점,21,21,126.8860014,37.42094318,42
코스트코 상봉점,6,7,127.0902129,37.59686502,13
코스트코 송도점,8,8,126.6330696,37.38994914,16
코스트코 양재점,10,10,127.0362879,37.46193109,20
코스트코 의정부점,2,3,127.1191853,37.75127433,5
코스트코 일산점,22,22,126.7884791,37.64065017,44
코스트코 하남점,15,14,127.1938755,37.55042199,29
코아모텔,1,1,126.9614404,37.39322241,2
코아식당,4,4,127.5767119,34.96452151,8
코에오,4,4,126.9921164,37.53353037,8
코엑스,140,142,127.0588376,37.51263173,282
코엑스 아쿠아리움,17,20,127.0587084,37.51330115,37
코엑스아티움,4,4,127.0615459,37.50994347,8
"코오롱레이크폴리스III오피스텔(A,B동)",8,8,126.4699422,35.50303019,16
코유,3,4,127.3980127,37.31429063,7
코이라멘,5,5,127.4899078,37.49108668,10
코이라멘 분당야탑점,5,5,127.1268258,37.41052515,10
코이라멘 서초점,2,1,127.0286181,37.48723716,3
코이라멘 수원영통점,3,4,127.0757683,37.25251082,7
코이펜션,3,3,127.5235894,37.80341169,6
코자요,5,5,126.9226968,37.55226414,10
코지블루,9,9,127.1103031,37.50921693,18
코지빌라커피,5,5,126.9924332,37.53292852,10
코지앤레이지,13,13,127.4020915,37.7204592,26
코지프로젝트,5,5,127.0162762,37.28724296,10
코코로카라,4,5,126.9209438,37.55979892,9
코코버블티 홍대입구점,3,3,126.9230099,37.55372757,6
코코시에나 티하우스,4,4,126.9254397,37.56165069,8
코코아게스트하우스,5,5,126.9218148,37.54977564,10
코코이비인후과의원,3,3,127.0005569,37.57120317,6
코코이찌방야 롯데백화점수원점,4,4,126.9977509,37.26439908,8
코코이찌방야 롯데아울렛광명점,5,5,126.8846484,37.42358365,10
코코커피,2,2,126.9862478,37.56445842,4
코트야드 바이 메리어트 수원,65,67,127.0574929,37.2846117,132
코트야드 바이 메리어트 수원키친,13,12,127.0574885,37.28472343,25
코트야드 바이메리어트 서울 보타닉파크,24,24,126.8294306,37.56697502,48
코트야드 바이메리어트 서울 판교,29,29,127.1107354,37.39749815,58
코트야드 바이메리어트 서울타임스퀘어,10,10,126.9043133,37.51719094,20
코트야드메리어트 모모카페,5,5,127.1105501,37.39740461,10
코히별장,5,5,126.6247136,37.47270605,10
콘래드 서울,23,24,126.9267428,37.52542773,47
콘부 더현대 서울,4,3,126.9280842,37.52578175,7
콘스탄스,5,5,127.0413562,37.50288208,10
콘유,5,5,127.0218771,37.51919727,10
콘타이,3,3,126.4557864,37.4371926,6
콘텐츠박스,24,24,127.004139,37.58069597,48
콘텐츠플래닝,4,4,127.0036997,37.58010133,8
콘하스 한남,5,5,126.9980539,37.5368409,10
콜링우드,10,12,127.0153582,37.28732868,22
콜스커피,5,5,127.009788,37.28367736,10
콤바크,3,4,126.9671992,37.55502032,7
콤콤오락실,18,18,126.9899818,37.57306961,36
콩VR 잠실롯데월드몰점,5,5,127.1040659,37.51365193,10
콩마루,5,5,127.2091906,37.89341339,10
콩사랑콩나물국밥,4,3,129.0414192,35.11510918,7
콩예원,5,5,127.1109447,37.55146967,10
콩이여무네,3,3,127.4315552,37.39722019,6
콩치노 콩크리트,23,23,126.6863928,37.79667537,46
콩카페 롯데백화점 잠실점,4,4,127.0985721,37.51190599,8
콰트로박스,9,9,126.7333427,37.70722244,18
콴꼬이,5,5,127.0551391,37.54299178,10
콴완다오,4,4,127.0214852,37.5184448,8
쿠라우니,3,3,127.0220807,37.51902604,6
쿠시카츠쿠마 평촌점,5,5,126.9626991,37.39415086,10
쿠에른 롯데백화점 본점,5,5,126.9818084,37.56510022,10
쿠우쿠우 미사점,5,5,127.1910278,37.56622559,10
쿠우쿠우 별내점,3,3,127.1253423,37.64621153,6
쿠우쿠우 삼송원흥점,5,5,126.8748308,37.64978952,10
쿠우쿠우 상암점,4,4,126.8942748,37.57853677,8
쿠우쿠우 연신내점,5,5,126.9216847,37.61967215,10
쿠우쿠우 은계점,5,5,126.8038747,37.43716186,10
쿠우쿠우 일산호수공원점,5,5,126.7704419,37.65411766,10
쿠우쿠우 주안역점,3,3,126.6825089,37.46347797,6
쿠차라 SFC점,5,5,126.9782579,37.5684225,10
쿠치나디까사 갈매점,4,4,127.1169646,37.63211342,8
쿠키샾,3,3,127.0533617,37.54500993,6
쿰피르 혜화점,5,5,127.0048636,37.58058422,10
쿼츠,4,4,126.9718396,37.53295424,8
퀴논길,3,3,126.9918867,37.53386913,6
퀴즈노스서브 송파방이점,5,5,127.1079532,37.51423229,10
퀴즈노스서브 역삼점,2,2,127.041514,37.50183685,4
퀴진라끌레,4,4,126.9702893,37.57921107,8
퀸넬브릴,6,7,126.9250252,37.5642435,13
퀸비코인노래연습장 신도림역점,3,3,126.8894959,37.510525,6
퀸스타운애견펜션,5,5,127.6150423,37.64652999,10
퀸즈베이커리카페,4,4,126.9791429,37.56098674,8
퀸타운호텔,14,15,126.7730679,37.65736807,29
크낙새가든,4,5,127.1883331,37.74673731,9
크라운수상레저,5,5,127.4578536,37.70992716,10
크라운파크호텔서울,1,2,126.9807765,37.56376659,3
크라운호텔,1,1,126.9881863,37.57405693,2
크라운호프 송도한라웨스턴파크점,5,5,126.6289612,37.40603929,10
크라이치즈버거 부천대점,10,10,126.779379,37.48817351,20
크라이치즈버거 삼성역점,6,6,127.0655378,37.50916015,12
크래머리 브루어리,13,13,127.3940678,37.76045666,26
크래버대게나라 하남점,4,4,127.1929584,37.56211031,8
크래커,4,4,126.9232875,37.55899858,8
크래프트루,10,10,126.9894543,37.57307677,20
크래프트한스 이태원점,3,3,126.9921887,37.53484584,6
크러스티,5,5,126.8879573,37.66188128,10
크럼앤크러스트,4,4,127.189936,37.57487419,8
크레마노분당에스프레소,5,5,127.1123125,37.37813368,10
크로와상점,3,4,127.0713136,37.54202716,7
크로플각,5,5,127.0061922,37.56189662,10
크루아,3,4,127.1646162,37.61247633,7
크리드코인노래연습장,5,5,126.9540794,37.27500086,10
크리미데이지,5,5,126.7238146,37.49336901,10
크리스월드,7,8,127.5416977,37.76040752,15
크리스찬 디올 성수,15,15,127.0524648,37.54402825,30
크리스탈제이드 소공점,2,2,126.9812789,37.56431087,4
크리스탈제이드 에버랜드점,3,3,127.2037186,37.29519702,6
크리스탈제이드 용산아이파크몰점,2,3,126.9647473,37.52978982,5
크리스피크림도넛 영등포점,5,5,126.9074736,37.51547795,10
크림라벨,2,3,127.0423082,37.54655332,5
크림시크,3,3,126.9839626,37.56435722,6
큰맛설렁탕냉면,4,4,127.0066996,37.29903757,8
큰손조개구이칼국수,3,3,126.6922467,37.3477843,6
큰손집,5,5,126.777652,37.76021019,10
클라임바운스 수원점,4,4,127.061899,37.24512311,8
클랩피자,5,5,127.0365849,37.52409509,10
클럽FF,5,5,126.9223096,37.55027088,10
클럽에스프레소,5,5,127.4838205,37.67732373,10
클럽케이서울,15,15,127.0483908,37.506642,30
클레어스서울,4,4,127.0246332,37.52055724,8
키득키득아트홀,5,5,127.0043066,37.58132666,10
키라네,3,3,128.6026902,38.19073873,6
키르케,5,5,126.9843405,37.49425033,10
키모토,5,5,127.0003713,37.57199244,10
키쉬미뇽,5,5,126.9162181,37.549081,10
키스톤 스피시즈,10,10,127.2254798,37.63656088,20
키이스케이프 강남 더오름,5,5,127.0310982,37.49661422,10
키자니아 서울,7,8,127.0969183,37.51087571,15
키친마이야르,10,10,127.0354232,37.52660924,20
키쿄우,4,4,126.7044113,37.44686791,8
키토빵앗간,4,4,126.6606646,37.38246208,8
킨텍스,26,27,126.7464511,37.66955186,53
킨텍스 제1전시장,45,46,126.7463518,37.66912204,91
킨텍스 제1전시장 2홀,4,4,126.7465624,37.66947732,8
킨텍스 제1전시장 3홀,5,5,126.7459795,37.66889584,10
킨텍스 제1전시장 4홀,10,8,126.7460174,37.66843462,18
킨텍스 제2전시장,33,34,126.7418096,37.66463056,67
"킨텍스 제2전시장 7홀(캠핑,레포츠 페스티벌)",5,5,126.7434249,37.66424847,10
킨텍스바이케이트리,41,39,126.7480577,37.66841376,80
킨텍스캠핑장,10,10,126.7392526,37.66336357,20
킴스퀘어,5,5,127.0035323,37.58188531,10
킵댓 로스터리,17,17,127.0141272,37.28360844,34
킵댓 본점,26,27,127.0113671,37.28604965,53
킷사서울,1,1,126.9537818,37.47921621,2
킷사텐,1,2,126.7804048,37.48691762,3
킹덤락볼링장,5,5,126.7266589,37.49357385,10
킹덤키즈풀빌라,5,5,127.5408867,37.7065122,10
킹마트 용문점,4,4,127.5932154,37.48796058,8
킹스배케이션,2,2,126.9617537,37.53198103,4
킹콩부대찌개 은평구청점,5,5,126.9272013,37.60305784,10
킹콩부대찌개 철원동송점,5,5,127.2172286,38.21000373,10
타논55,2,3,127.0535364,37.54399984,5
타르타르 여의도점,5,5,126.9263103,37.52234694,10
타셴,3,3,127.0037135,37.58294487,6
타운 앤 컨트리 햄버거스,5,5,126.9223648,37.49922554,10
타이밍 뮤직바,4,4,127.0421933,37.47904473,8
타이쇼,5,5,127.0351956,37.48525677,10
타이어뱅크 별내700개점,2,2,127.1327188,37.66401317,4
타이홀릭,2,3,127.0265878,37.26451145,5
타임모텔,3,3,127.1087582,37.51555963,6
타임스퀘어,69,70,126.9030714,37.51710524,139
타임스트림,4,4,126.9303405,37.48388636,8
타임애프터타임,5,5,127.0522378,37.54296517,10
타임인,5,5,126.6083497,37.215579,10
타임캡슐,4,4,126.9648241,37.53007636,8
타임테라스 A블럭,5,5,127.0692435,37.20491969,10
타지,5,5,126.9862342,37.56441066,10
타코드부로,3,3,126.9975157,37.52584687,6
타코몽,5,5,126.9320911,37.55706413,10
타코벨 서울고속터미널점,4,4,127.0055757,37.50555796,8
타코비리아,3,4,126.892958,37.51373847,7
타파스바,2,2,126.9925326,37.53484947,4
탄도어촌체험마을,4,4,126.6450637,37.19298832,8
탄도어항수산물직판장,4,4,126.646164,37.19157066,8
탄도항,14,14,126.6448886,37.19263369,28
탄요공원,4,4,127.0751525,37.18961353,8
탄천민물고기습지생태원,4,4,127.1183982,37.44780534,8
탄천자전거길,5,5,127.1238878,37.40431844,10
탄탄면공방 파르나스몰점,4,4,127.0608044,37.50919151,8
탈리,4,3,126.934788,37.5572035,7
탐광,2,3,127.0554119,37.54317095,5
탐나종합어시장 신사역점,4,4,127.0223269,37.51762494,8
탐스커버리 화성행궁점,4,4,127.0168635,37.28122574,8
탐앤탐스 금강휴게소점,4,3,127.6731076,36.27898614,7
탐앤탐스 소리소점,5,5,127.181167,37.65082683,10
탐앤탐스 역삼르까프골프장점,2,3,127.0648392,37.50306253,5
탐앤탐스 종로5가점,4,4,126.9990888,37.57110856,8
탐앤탐스 종로한올타워점,3,3,126.9882277,37.56989794,6
탐앤탐스 하남검단산점,3,3,127.2304572,37.53787564,6
탐앤탐스블랙 더스토리지점,4,4,127.1931897,37.59466371,8
탑골공원,14,15,126.9883452,37.57116655,29
탑골순대국,4,4,127.0974371,37.32488167,8
탑뷰카페,5,5,127.8644016,37.01730862,10
탑재산,4,4,126.6194977,37.176436,8
탑클라우드호텔 수원점,14,14,127.0108899,37.29244257,28
탑텐 롯데월드타워몰점,3,3,127.1040051,37.51387903,6
탑토,4,4,127.0387843,37.52670008,8
태강이네 멍멍마켓,5,5,127.0702273,37.65529137,10
태극당,13,12,127.0050704,37.55950453,25
태극당 서울역광장점,3,3,126.9709067,37.55496813,6
태극당 서울역점,5,5,126.9705889,37.55452116,10
태극당 인사점,5,5,126.9859257,37.57358456,10
태담이네하우스,10,10,129.2984632,36.02613191,20
태릉입구역 6호선,3,3,127.0747518,37.61734991,6
태릉입구역 7호선,5,5,127.0754053,37.61845951,10
태리힐펜션,5,5,127.3570224,37.86171401,10
태림봉,3,3,126.6194865,37.4739994,6
태봉 감자탕병천순대국,1,1,127.2302507,37.39246031,2
태성당 부산역점,4,4,129.0416394,35.11514242,8
태성마트,5,5,127.5941152,37.48507648,10
태양짬뽕 본사직영점,5,5,126.8546918,37.76732185,10
태을봉,3,4,126.913935,37.37310094,7
태을봉 쭈꾸미&누룽지백숙,2,2,126.8173965,37.50374289,4
태풍전망대,8,9,126.9738097,38.12651505,17
태화강역,5,5,129.3534992,35.53881719,10
태화산명가,21,21,127.333642,37.3454111,42
태화원,7,7,126.6185684,37.47402887,14
태화장 본점,5,5,127.042692,37.27612927,10
태희네 착한정육식당,5,5,127.1327942,37.4418028,10
택이네조개전골 광명역점,5,5,126.8844438,37.42146065,10
탬버린즈 플래그십 스토어,25,24,127.0220133,37.52065687,49
탭하우스F64,4,4,127.0043252,37.58975275,8
탱고오나다,5,5,126.9225237,37.55771326,10
터미널 스넥,5,5,127.4469547,37.27778096,10
터치,5,5,127.0684435,37.54140356,10
턴업,4,4,126.9988567,37.49788512,8
털보네바베큐 미사동본점,4,5,127.2013422,37.57169659,9
텅 성수 스페이스,5,5,127.0565428,37.54226041,10
테디뵈르하우스,10,10,126.9725325,37.5315984,20
테디스오븐,2,4,127.0434647,37.54647361,6
테라로사 경포호수점,5,5,128.9075034,37.78786133,10
테라로사 국립현대미술관서울점,4,4,126.9805959,37.5793754,8
테라로사 사천점,8,8,128.8850279,37.82237031,16
테라로사 서종점,16,17,127.3552854,37.62469803,33
테라로사 코엑스점,8,8,127.0594265,37.51166097,16
테라로사 포스코센터점,5,5,127.0558798,37.50596474,10
테라로사 한남점,4,4,127.4292323,36.48685981,8
테라로사서종,5,5,126.2292343,33.23848105,10
테라스룸,3,4,127.0426714,37.52464265,7
테라코타 용산점,3,3,126.964521,37.52986184,6
테르메덴,37,38,127.4459522,37.19472696,75
테르메덴 실외온천풀,15,15,127.4458425,37.19447508,30
테르트르카페,5,5,127.0112257,37.57822138,10
테마모텔,5,5,126.9649199,37.5669813,10
테이블32,10,9,126.8988606,37.48318064,19
테이블에이 본점,2,3,126.9295169,37.55405959,5
테이스티,5,5,127.4961068,37.67571942,10
테이크웨이브,5,5,127.0603996,37.28697277,10
테이크호텔,42,43,126.8832183,37.41913482,85
테일러커피 서교점,3,3,126.9276023,37.55386742,6
테크노마트,11,10,127.0956855,37.53572095,21
텍사스로드하우스 현대프리미엄아울렛 김포점,4,4,126.7864677,37.59918226,8
텍사스로드하우스 현대프리미엄아울렛 송도점,3,3,126.6576731,37.38181914,6
텍사스로드하우스 현대프리미엄아울렛 스페이스원점,5,5,127.1524281,37.61625883,10
텐8,5,5,126.9864153,37.57716877,10
텐동식당,3,3,127.0548936,37.543301,6
텐코인노래연습장 송산그린시티본점,3,3,126.8172261,37.28545767,6
텐트인더시티,5,5,126.8724186,37.14725237,10
텐퍼센트커피안국점,5,4,128.5915526,38.20426919,9
템플,4,4,126.9295279,37.55442541,8
토가,6,6,126.7402667,37.77747995,12
토끼네잡화상점,5,5,127.0432769,37.24804626,10
토끼정 KTX서울역사점,2,2,126.9700541,37.55593829,4
토끼정 수원역사점,4,4,127.0002931,37.26604801,8
토닭토닭 숯불닭갈비,4,4,127.5208326,37.8641936,8
토담,7,8,127.4264326,37.5153447,15
토담골,4,5,126.8740387,35.19736235,9
토라비,5,5,126.9255772,37.55549517,10
토리카미,5,5,126.9914848,37.56532837,10
토마스모어,10,10,127.0026816,37.53790406,20
토방,3,4,126.838823,37.38491054,7
토속음식뜰사랑 판교직영점,4,4,127.0767352,37.39094043,8
토속촌삼계탕,14,14,126.9714945,37.57772293,28
토요코인호텔 부산서면,5,5,129.0640237,35.15793797,10
토요코인호텔 서울동대문2,13,13,127.0078201,37.56449319,26
토요코인호텔 영등포점,8,8,126.9120126,37.5176222,16
토요코인호텔 인천부평점,10,10,126.7220705,37.49044566,20
토우드,5,6,127.0533093,37.54286738,11
토이로봇관,2,2,127.6920865,37.89208728,4
토이저러스 파주점,3,3,126.6931692,37.71967886,6
토이쩔어스,5,5,127.065799,37.54006168,10
토이킹덤 스타필드 하남점,3,3,127.2238942,37.54488722,6
토종순대가,2,2,127.6399841,37.26509312,4
토토가요,1,1,127.024835,37.50156763,2
토평메주콩,5,5,127.1463387,37.58376242,10
토향,6,8,126.6898923,37.78195936,14
톤티커피,5,5,126.9863054,37.57764269,10
톨장군네,4,4,127.0446908,37.38039779,8
통나무집 숯불닭갈비,2,3,127.7825735,37.93017906,5
통나무집닭갈비 3호점,8,9,127.7834141,37.93029058,17
통복시장,7,6,127.0834654,36.9968497,13
통의동단팥,4,4,126.9722415,37.57795737,8
통인시장,41,44,126.9700261,37.58077513,85
통일동산 장어마을,5,5,126.6900634,37.78502578,10
통일동산두부마을,14,15,126.6887071,37.78306442,29
통일바라기축제,1,1,126.8585117,37.98620634,2
통큰만두전골,5,5,126.8506672,37.66505827,10
통큰손쭈꾸미마을 배곧점,5,5,126.727918,37.36950984,10
통큰칼국수,5,5,127.0188862,37.27597597,10
통큰횟집,5,5,127.4437545,37.25181436,10
통통돼지뽈살,2,3,126.9241318,37.55564652,5
통툰 영등포점,5,4,126.90731,37.51789251,9
퇴근길,10,10,127.5140065,37.82611365,20
퇴촌갈비밥,5,5,127.3506536,37.47761652,10
투다리 거여역점,5,3,127.1461617,37.49314732,8
투다리 복돼지점,5,5,126.7856254,37.49517862,10
투로맨틱버즈펜션,5,5,127.1559371,37.80140696,10
투버드스튜디오,1,1,127.0308769,37.57422287,2
투스텝,3,3,126.9300849,37.48508365,6
투썸플레이스 가산대성디폴리스점,2,2,126.8772822,37.47981746,4
투썸플레이스 강남대륭타워점,2,3,127.0293256,37.49518748,5
투썸플레이스 고모호수점,4,4,127.1649393,37.79532674,8
투썸플레이스 고양삼송미디어시티점,4,4,126.8978007,37.64923142,8
투썸플레이스 공덕풍림빌딩점,5,5,126.9522206,37.54634851,10
투썸플레이스 광릉수목원점,4,4,127.1660446,37.77374536,8
투썸플레이스 마포공덕점,4,4,126.9543133,37.54767741,8
투썸플레이스 마포대로점,5,5,126.9483005,37.54184907,10
투썸플레이스 마포역점,5,5,126.9471137,37.54001861,10
투썸플레이스 명동L7점,4,4,126.9869727,37.56140142,8
투썸플레이스 명동역점,1,1,126.9856374,37.560175,2
투썸플레이스 미사호수공원점,1,3,127.1882433,37.56663822,4
투썸플레이스 삼성역점,1,1,127.0610296,37.50786692,2
투썸플레이스 상암MBC점,3,3,126.890988,37.58111963,6
투썸플레이스 서린동청계광장점,8,6,126.9795005,37.56941021,14
투썸플레이스 서울대점,8,8,126.9482162,37.45920426,16
투썸플레이스 서종리버사이드점,1,1,127.3537332,37.62463512,2
투썸플레이스 성수낙낙점,4,4,127.0652799,37.5467681,8
투썸플레이스 송파구청사거리점,8,10,127.1072486,37.51509789,18
투썸플레이스 수원고등점,5,5,127.0019799,37.27399788,10
투썸플레이스 수원역로데오점,9,9,127.0053327,37.26833653,18
투썸플레이스 신림역점,4,4,126.9298269,37.48538894,8
투썸플레이스 압구정CGV점,3,3,127.0294241,37.52420521,6
투썸플레이스 여주강변점,10,10,127.6500037,37.29337935,20
투썸플레이스 영등포역점,5,5,126.9069156,37.51671189,10
투썸플레이스 예금보험공사점,4,4,126.9808817,37.56856351,8
투썸플레이스 용산아이파크몰점,2,3,126.9651728,37.52939531,5
투썸플레이스 은평한옥마을점,5,5,126.9392776,37.64231528,10
투썸플레이스 을지로입구역점,5,5,126.9834406,37.56515813,10
투썸플레이스 인덕원역점,3,3,126.9746871,37.40295071,6
투썸플레이스 장안점,4,3,127.0683768,37.56752893,7
투썸플레이스 제일제당사옥점,4,3,127.003253,37.56397353,7
투썸플레이스 종각역점,5,5,126.9853955,37.56995619,10
투썸플레이스 킨텍스꿈에그린점,3,3,126.7490091,37.66523534,6
투썸플레이스 팔당점,5,5,127.2283072,37.56747934,10
투썸플레이스 평택리버타워점,4,4,126.9811368,36.99302542,8
투썸플레이스 학동사거리점,4,4,127.0395691,37.52393104,8
투썸플레이스 화성북양DT점,4,4,126.845187,37.22312556,8
투파인드피터 범계점,5,5,126.9550219,37.3906252,10
투헌드레드,5,5,127.0221601,37.51991802,10
툴롱,5,5,126.6435519,37.38596986,10
트니트니어드벤처,5,5,127.4032402,37.71391426,10
트라이보울,9,11,126.6350093,37.39420434,20
트래고드,2,3,127.034141,37.48600221,5
트레든베이커리카페,1,3,127.1101841,37.81349094,4
트레블로지 명동을지로점,5,5,126.9893692,37.56662203,10
트레블로지동대문호텔,4,4,127.0018835,37.56641346,8
트로이,4,4,126.9939945,37.53389088,8
트리뷰카페,3,4,127.3739086,37.12438416,7
트리쉐이드호텔,6,6,127.0059537,37.56536817,12
트리캠핑장,5,5,126.5153308,37.25650874,10
트리플스트리트,66,66,126.6609975,37.37999514,132
트리플에이커피 신당점,5,5,127.01488,37.56678465,10
트윈캐슬오피스텔,9,9,126.9693597,37.45037813,18
트윈하우스카페,4,4,127.1883193,37.74709736,8
틈새라면 신촌점,3,2,126.9373551,37.55692198,5
틈새라면 이천터미널점,5,5,127.4469313,37.27744226,10
티노마드 모리,7,7,126.9009166,37.55555814,14
티로헤어,4,3,129.0646834,35.48828455,7
티롤관광호텔,1,1,127.0169849,37.51504445,2
티볼리빌펜션,5,5,127.235038,37.76961686,10
티앤림 레포츠파크,3,3,128.3137168,34.90836951,6
티오엠 1관,5,5,127.0036455,37.58227453,10
티프,5,5,127.0043237,37.5642492,10
티하우스레몬 신반포점,4,4,127.0070517,37.50606695,8
틴틴홀,14,14,127.0035549,37.58160059,28
팀호완 삼성점,12,13,127.0568475,37.51142707,25
팀호완 잠실점,9,8,127.0981404,37.51131078,17
파네트리 제과명장 김영모,2,3,127.1040571,37.42003871,5
파도마루,4,4,126.5683501,37.28125447,8
파도횟집,4,5,126.5718656,37.28568951,9
파라다이스시티,8,8,126.4557647,37.43722223,16
파라다이스시티 레드윙,5,5,126.4561747,37.43786653,10
파라다이스시티 원더박스,5,5,126.4573003,37.43657966,10
파라다이스시티 플라자,4,4,126.4583317,37.43709977,8
파랑,5,5,127.0529859,37.58479809,10
파랑새네거리,5,5,127.3794979,36.35359833,10
파랑씨어터,5,5,127.0024726,37.5824872,10
파레스모텔,4,4,127.0352549,37.56321508,8
파로마가구 마석가구공단점,3,3,127.2843364,37.65361813,6
파롤앤랑그 연남본점,10,10,126.9228557,37.56498993,20
파르나스몰,7,8,127.0608317,37.50930683,15
파리공원,4,4,126.8771616,37.5347678,8
파리바게뜨 가야현대점,4,4,129.0415599,35.15588649,8
파리바게뜨 가평점,5,5,127.5138532,37.82989109,10
파리바게뜨 강남서초점,3,3,126.9462883,35.9402174,6
파리바게뜨 경복궁역점,3,3,126.9722715,37.57665454,6
파리바게뜨 광교중흥점,10,10,127.0566015,37.28384985,20
파리바게뜨 남양중앙점,3,3,126.8322748,37.20974904,6
파리바게뜨 덕소도심점,3,3,127.2206594,37.57953476,6
파리바게뜨 부천도당점,5,5,126.792466,37.52001708,10
파리바게뜨 성결대사거리점,3,3,126.9336694,37.38367817,6
파리바게뜨 세종반곡점,4,4,127.3116255,36.49807752,8
파리바게뜨 안산네오빌루비점,3,4,126.8325419,37.31252762,7
파리바게뜨 역삼특허청점,3,3,127.0316414,37.49736371,6
파리바게뜨 제주공항렌터카하우스점,3,3,126.4919499,33.50469721,6
파리바게뜨 평택중앙점,4,4,127.0877824,36.9927755,8
파머스대디 영동,5,5,127.3784604,37.47667296,10
파머스빌리지플러스 양주점,4,5,127.076043,37.80716527,9
파머스테이블,5,5,126.6954999,37.79030786,10
파미어스몰,13,13,127.0983285,37.41316254,26
파미에스테이션,24,24,127.0042795,37.50318477,48
파사성,9,9,127.5493075,37.41122364,18
파사성주차장,3,3,127.5437489,37.40669023,6
파스쿠찌 까치산역점,5,5,126.8477692,37.53049886,10
파스쿠찌 여의도KBS본관점,5,5,126.9176476,37.52623625,10
파스쿠찌 유명산DI점,4,4,127.4940965,37.59950164,8
파스타마켓,7,8,126.9980784,37.571386,15
파스타바코 본점,3,3,126.9263339,37.55938074,6
파스타집이야 송파점,3,3,127.1090285,37.5131537,6
파스텔커피웍스 서촌점,5,5,126.9687771,37.57873316,10
파슬리,3,5,127.0497583,37.73632115,8
파운드리 서울,4,4,126.9985291,37.53546237,8
파육칼,5,5,127.4761092,37.50051709,10
파이리퍼블릭,3,3,126.9257726,37.55930471,6
파이어벨 심팩트 롯데프리미엄아울렛 타임빌라스점,4,4,127.00952,37.37598632,8
파이키,10,10,126.9923883,37.57388969,20
파이프그라운드,8,7,127.0029871,37.53958893,15
파인시티호텔,3,3,128.8991513,37.76080896,6
파인트리글램핑&캠핑장,5,5,127.3642428,38.02069144,10
파인힐커피하우스,10,10,127.0441842,37.92418701,20
파주 그라체호텔 금촌점,8,8,126.7724058,37.76424551,16
파주 삼릉,5,5,126.8028655,37.55894903,10
파주DMZ곤돌라,3,4,129.2848194,35.83630295,7
파주골토박이순두부,5,5,127.2771197,38.02700036,10
파주공룡박물관,4,4,126.6969726,37.79109189,8
파주놀이구름,5,5,126.7591481,37.72283775,10
파주닭국수 가평점,4,3,127.506101,37.85204827,7
파주닭국수 배곧베니스스퀘어점,3,3,126.7306652,37.36810242,6
파주닭국수 파주본점,6,8,126.7856499,37.76981848,14
파주닭국수 풍동점,3,3,126.8005048,37.66658604,6
파주디엠지곤돌라,4,4,126.7402783,37.89144959,8
파주롯데프리미엄아울렛,5,5,126.9405375,33.45913497,10
파주삼릉,5,4,126.8329587,37.74453465,9
파주신세계프리미엄아울렛 전기차충전소(테슬라전용),5,5,126.6933269,37.76997657,10
파주옥 미리내직영점,5,5,127.2465015,37.10820286,10
파주임진각평화곤돌라,5,5,126.7402738,37.89144778,10
파주임진각평화곤돌라 DMZ탑승장,4,4,126.7322787,37.89540303,8
파주장단콩웰빙마루,9,9,126.684464,37.77714284,18
파주축산한우마을 본점,4,4,126.9167221,37.95672935,8
파주출판도시,16,17,126.6866399,37.7090807,33
파주출판도시 자유로휴게소 주차장,5,4,126.6842671,37.69953849,9
파주출판도시 휴게소,4,4,128.5642605,37.78677952,8
파주코다리,5,5,126.7324866,37.70687633,10
파주팜랜드,1,1,126.6923823,37.81004694,2
파주프리미엄아울렛,119,119,126.6963345,37.76947081,238
파츠 강남N점,3,3,127.0323662,37.49993319,6
파크마린호텔,10,10,126.7348063,37.4010441,20
파크뷰테라스호텔,10,10,126.7620566,37.71639902,20
파크프리베,4,4,127.0609832,37.70623422,8
파크하얏트 서울,25,25,127.0642831,37.50873196,50
파크하얏트서울 더라운지,5,5,127.0641699,37.50860588,10
파타고니아 더현대서울점,5,5,126.9284008,37.52598287,10
파타고니아 서울가로수길직영점,5,5,127.0236916,37.51936811,10
파타타,4,4,127.3395975,37.34566086,8
파트브리제,4,4,127.0155553,37.28622848,8
파티세리아파리,4,4,127.0630135,37.28682995,8
파티세리희원,3,3,126.9876058,37.57927002,6
파티오세븐,20,19,127.0293062,37.51780992,39
파티웨딩유,6,6,126.9953593,37.27152084,12
파티즈호텔,5,5,126.9716561,37.28173173,10
파파밸리,5,5,127.0042932,37.50528231,10
파파스차이나,5,5,127.0510569,37.74390316,10
파파야리프,5,5,127.0276515,37.50296897,10
파평코스모스축제,7,8,126.813468,37.89007113,15
판곡초등학교,3,3,127.2417865,37.65998384,6
판교박물관,5,5,127.0955614,37.40107222,10
판교역,9,9,127.7702147,34.45373702,18
판교역 1번출구 앞 포장마차,4,4,126.4167048,33.25798111,8
판교역 신분당선,27,27,127.1111978,37.39477753,54
판교환경생태학습원,3,4,127.1038176,37.39959119,7
판다익스프레스 IFC몰점,5,5,126.9254995,37.52549003,10
팔각도 수원인계점,3,4,127.3145153,37.99597034,7
팔각도 영등포점,10,10,126.9085324,37.51728168,20
팔각도 하남 미사역점,5,5,127.1906623,37.56536844,10
팔공티 송도밀레니엄점,4,4,126.651219,37.39572372,8
팔달구청 주차장,2,3,127.020178,37.28279213,5
팔달문,5,5,127.016742,37.27756753,10
팔달문시장,69,67,127.0176665,37.27720338,136
팔달문화센터,4,4,127.0184889,37.28330509,8
팔달산,13,13,127.0099117,37.28073606,26
팔당남원추어탕 조개울점,5,5,127.2542975,37.54129735,10
팔당역 경의중앙선,10,10,127.2439662,37.54735943,20
팔당원조칼제비 도곡점,5,5,126.9065633,35.03920218,10
팔당제빵소,7,7,127.2348208,37.55973604,14
팔당초계국수 본점,21,21,127.2547178,37.54110544,42
팔딱산,4,5,127.012532,37.2867222,9
팔레드신,4,5,126.9795371,37.55973352,9
팔레센트,26,29,127.014807,37.28871725,55
팔미도유람선,5,5,126.6017677,37.45555328,10
팔백집,5,5,127.019837,37.58947726,10
팔베개,5,5,127.0130583,37.28453664,10
팔봉산관광지,4,4,127.6954961,37.70185629,8
팔선생,4,4,126.9633421,37.39562694,8
팔숲,4,4,127.2390334,37.5632775,8
팔월잔칫날,5,5,127.107616,37.54800481,10
팔월팔일,4,4,127.1284205,37.53990116,8
팔진향 디큐브점,3,4,126.8895658,37.50916455,7
팔팔낙지본점,2,3,129.2177684,35.1920185,5
팜비치펜션,3,3,126.3798632,37.4416444,6
팜스마트,3,3,126.8920076,37.59473096,6
팜호텔,3,4,126.7215322,37.35255662,7
팟알,13,13,126.6205768,37.4739074,26
팡팡노래연습장,5,4,126.8033944,37.437198,9
팥고당 롯데몰수원점,3,3,126.9974206,37.26403685,6
패킷,3,3,127.0354329,37.50891172,6
패터슨커피,10,10,127.0115158,37.28507562,20
팩토리공공공,3,4,127.011739,37.28474401,7
팬케이크 지비지컬러인,5,5,127.1093961,37.32137701,10
팬케익팬트리,2,3,127.0676113,37.53210932,5
팻어케이크,8,9,127.110172,37.50929274,17
팽성 제1공영주차장,5,5,127.0460806,36.95735389,10
퍼먼트,10,10,127.0427519,37.54663515,20
퍼센트아라비카,3,3,127.0597433,37.51173289,6
퍼센트아라비카 1호점,9,10,127.0600811,37.50991269,19
퍼스널커피,5,5,126.9037402,37.55472615,10
퍼스널테라피연구소,5,5,127.1922239,37.5492991,10
퍼스트가든,29,32,126.7946254,37.73207316,61
퍼스트보드게임카페 구월점,5,5,126.7017095,37.44453471,10
퍼스트파티오,7,9,127.5143969,37.81477532,16
퍼키드,4,4,127.0115733,37.28509904,8
퍼틴 판교점,5,5,127.0971545,37.41205616,10
퍼퓰러,5,5,127.006565,37.56597721,10
퍼프x오지코스트,9,9,126.922245,37.5601755,18
펀비어킹 송파가락로점,3,3,127.1136336,37.50375369,6
펀비어킹 파주산내마을점,5,6,126.7359009,37.72899024,11
펀시티,5,5,127.068792,37.54142859,10
펀타임 대학로,4,2,127.0002581,37.58338101,6
페럼타워,2,2,126.9841261,37.56698544,4
페리카나 양평용문점,2,3,127.5937602,37.48365469,5
페메종,10,10,127.1063578,37.51382648,20
페어링하우스,9,9,127.1899569,37.5625828,18
페어몬트 앰배서더 서울,37,37,126.9385418,37.52254478,74
페어몬트 앰배서더 서울 골드라운지,3,3,126.9291142,37.52519132,6
페어몬트 앰배서더 서울 더 아트리움 라운지,1,1,126.9291131,37.52519132,2
페어몬트 앰배서더 서울 스펙트럼,15,15,126.9291142,37.52519132,30
페어필드 바이메리어트 서울,13,13,126.9092816,37.51699304,26
페이브베이커리 미사역점,4,4,127.1919569,37.56438876,8
페이스갤러리,5,5,127.0011315,37.53848974,10
페이퍼돌메이트아틀리에,3,4,127.0437973,37.54635996,7
페이퍼마쉐,5,5,126.9794778,37.56951833,10
페이퍼플레이트,5,5,127.0566951,37.54173775,10
페이페이 스타필드하남점,8,8,127.2237408,37.54543532,16
페인트커피&바,5,5,127.0046196,37.58917971,10
펜션마루,4,4,127.368659,37.69072206,8
펜타커피랩,4,5,127.3174798,37.38320665,9
펠리씨떼,3,3,126.6851097,37.79083013,6
펠리체가든,3,3,127.1540445,37.10990525,6
펠트커피 광화문점,5,5,126.9789205,37.57098054,10
편백가원 롯데백화점 영등포점,3,4,126.9076657,37.51566731,7
편백가원 일산백석점,2,2,126.7861045,37.64335964,4
편백집 롯데몰김포공항점,5,5,126.8032051,37.56323383,10
평강랜드,9,9,127.1602439,37.38974204,18
평강이네김치전문점,5,5,127.4577865,37.716718,10
평래옥,5,5,126.9903655,37.56491022,10
평양면옥,5,5,127.017085,37.27850096,10
평양면옥 송추점,5,5,126.9821312,37.72034437,10
평양면옥 의정부본점,5,5,127.04752,37.73092166,10
평양손만두 운정점,4,4,126.7635871,37.72763629,8
평양옥,3,3,126.6875211,37.78166479,6
평양초계탕막국수,4,4,127.4195246,37.50147942,8
평이담백 뼈칼국수 방이점,5,5,127.1253912,37.50928117,10
평장원 남문점,3,4,127.019037,37.27461538,7
평창갈비 마석점,5,5,127.2921917,37.66456925,10
평창휴게소 강릉방향,4,4,128.4529472,37.60536697,8
평촌로데오거리,5,5,126.9535426,37.39062462,10
평촌수산,5,5,126.9700783,37.38181435,10
평촌역 4호선,12,12,126.963808,37.39423951,24
평촌역광장,5,5,126.963948,37.39436209,10
평촌중앙공원,12,12,126.9591892,37.3900032,24
평택가로수길센트럴돔,4,4,127.1125177,36.99917574,8
평택고속버스터미널,10,9,127.0869087,36.99097397,19
평택국제중앙시장,8,9,127.0527455,37.0807233,17
평택남부문예회관 대공연장,4,4,127.1140841,36.99113119,8
평택대학교,9,9,127.1333153,36.9949831,18
평택문화원 웃다리문화촌,5,5,127.0082176,37.06878654,10
평택복합휴게소주유소 평택방향,5,5,126.9445333,37.04460346,10
평택비전지웰푸르지오아파트,10,5,127.1225101,36.99743397,15
평택소풍정원 캠핑장,5,5,127.0186025,37.01114892,10
평택시농업생태원,15,15,126.7650036,36.14231839,30
평택역,57,53,127.0852911,36.99098236,110
평택역 1호선,13,12,127.085273,36.99084901,25
평택일등마트,5,3,127.1036767,37.02844727,8
평택지제역,9,8,127.0698327,37.01878181,17
평택해장왕,5,5,127.0583665,37.07050793,10
평택햇살들주말농장,4,4,126.8663152,37.02508327,8
평택호 둘레길,5,4,126.2567055,33.40567956,9
평택호관광단지,11,11,126.912922,36.9148246,22
평택호예술공원,4,4,126.9239842,36.92195084,8
평화누리공원 바람의언덕,5,5,126.7430603,37.8922482,10
평화누리길 3코스(한강철책길),3,3,126.6461393,37.74456512,6
평화누리캠핑장,20,20,126.7484548,37.89605135,40
평화랜드,24,25,126.742019,37.89042995,49
평화문화진지,8,9,127.0470783,37.69080868,17
평화시장,5,5,127.0082632,37.56945495,10
평화식당,8,8,127.5496517,37.88612657,16
평화연남,2,3,126.9247519,37.56251161,5
평화의공원,8,8,126.8949472,37.56247083,16
포곡농협 본점,3,3,127.2295457,37.27665417,6
포곡농협하나로마트 본점,4,3,127.229892,37.2763138,7
포공영커피,23,25,127.1624879,37.78127335,48
포근베이커리,2,3,127.0964896,37.16591474,5
포근펜션,3,6,127.4589953,37.81859542,9
포남사골옹심이,5,5,128.9073738,37.76502628,10
포담,5,5,126.9734466,37.57637009,10
포도 을지로점,4,4,126.9903869,37.56565174,8
포도밭할머니칼국수전문점,10,11,126.5701574,37.28068979,21
포도원삼계탕 영종운서역점,3,3,126.4966299,37.49119317,6
포동푸딩 용산점,5,5,126.9614325,37.5242735,10
포디움126,3,4,126.6241905,37.47106456,7
포레나노원아파트,5,5,127.0623007,37.66397678,10
포레리버5972,5,5,127.1746014,37.51753313,10
포레리움,8,8,126.6290099,37.66522889,16
포레스타호텔,18,18,126.9580271,37.5841759,36
포레스트,4,4,129.2097415,35.8388301,8
포레스트 호수공원점,1,2,127.095228,37.16728176,3
포레스트아웃팅스 송도점,37,37,126.652362,37.42015453,74
포레스트아웃팅스 일산점,5,5,126.8134758,37.66561618,10
포레스트파크,5,5,127.109536,37.55781311,10
포르쉐 존더분쉬 하우스,3,4,126.9858654,35.32477981,7
포마토김밥,5,5,126.9596865,37.50721807,10
포말커피,5,5,126.927867,37.48579141,10
포메인 기흥구청점,5,5,127.1126334,37.28003444,10
포메인 송탄신장점,4,4,127.0530989,37.08101419,8
포메인 에버랜드직영점,5,5,127.2005216,37.29150643,10
포메인 코엑스점,5,5,127.0582044,37.51098402,10
포모르,5,5,127.1109675,37.51489984,10
포브라더스 종로점,4,4,126.9835865,37.57075153,8
포비 광화문점,5,5,126.9789273,37.57100667,10
포비 디엠지점,11,12,126.7402422,37.88942419,23
포비 파미에스테이션점,4,4,127.00437,37.50309917,8
포사이,4,4,127.3502841,37.47718783,8
포세이돈,8,8,127.5178785,37.70140499,16
포스트커피하우스 현대백화점 판교점,5,5,127.1121245,37.39295208,10
포스트포에틱스,5,5,127.0001448,37.5361111,10
포시즌스호텔 더마켓키친,1,1,126.975373,37.57070325,2
포시즌스호텔 서울,20,20,126.9754047,37.57068163,40
포식 구리인창점,3,4,127.1388733,37.60693051,7
포썸,5,5,127.0182213,37.59415187,10
포어플랜,3,5,127.0475011,37.54823891,8
포엠,3,3,126.9837738,37.56306066,6
포옥,3,4,127.1658907,37.77500692,7
포은 정몽주 선생 묘 (지역축제 포은문화제 개최),5,5,129.125325,35.56499638,10
포지타노 송파점,4,4,127.1096589,37.51265216,8
포지티브 인사동점,3,4,126.9835177,37.57460958,7
포차84,2,2,126.7882225,37.18464007,4
포차천국 인천옥련점,5,5,126.6444094,37.42389081,10
포천 가람누리  문화공원,4,4,127.2140422,38.0789302,8
포천 포레스트풀빌라,5,5,127.2775155,37.97367537,10
포천5일장,10,10,127.2025632,37.89405924,20
포천그린별캠핑장,4,3,127.1229982,37.95661886,7
포천농협하나로마트,4,4,127.2067309,37.90130099,8
포천농협하나로마트 창수점,5,5,127.1886908,37.99103755,10
포천반월성,5,5,127.2203643,37.89354436,10
포천산정호수명성산 억새꽃축제,2,5,127.3239249,38.06817885,7
포천아트밸리,90,97,127.2372456,37.92317415,187
포천이동갈비직판장,3,3,127.3665933,38.03622231,6
포천종합운동장,3,3,127.2006414,37.8880226,6
포천천,3,3,127.1452147,37.82275985,6
포천패션타운,5,5,127.12859,37.79856502,10
포천한탄강하늘다리,11,13,127.2192124,38.08398141,24
포케 올데이 철산점,3,4,126.8680834,37.47933272,7
포케올데이 평택역점,5,5,127.0869733,36.99246612,10
포퀸스카페,4,4,126.3051056,33.27627648,8
포크,3,3,126.6608122,37.38102177,6
포크너 인계점,4,5,127.0357099,37.26339536,9
포크포크 매콤돈가스&칡불냉면,5,5,126.971364,37.29681504,10
포탈,10,10,127.0241489,37.50255798,20
포토 시그니처 다산도농점,5,5,127.1628507,37.60843875,10
포토그레이 서울연남점,4,3,126.9246173,37.56010766,7
포토시그니처 서울대학로점,4,4,126.9995879,37.58290528,8
포토시그니처 서촌점,5,5,126.9719474,37.57748157,10
포토시그니처 수원행궁점,4,4,127.0139212,37.28541145,8
포토시그니처 홍대1호점,9,9,126.9218454,37.55269065,18
포토아이브 수원행궁점,3,3,127.0117219,37.28368619,6
포토이즘박스 건대점,3,4,127.0681458,37.54130192,7
포토이즘박스 성수점,5,5,127.0407379,37.54717736,10
포토이즘박스 수원행궁점,4,4,127.0139156,37.28558355,8
포토하임,5,5,127.0127221,37.2851065,10
포트링공방,4,4,126.9234909,37.55925099,8
포포민즈낫띵,4,4,127.0455131,37.54685126,8
포포인츠 바이 쉐라톤 조선 서울명동,20,20,126.9893388,37.56551831,40
포포인츠 바이 쉐라톤 조선 서울역,14,14,126.9728654,37.55103563,28
포포인츠 바이쉐라톤 서울강남,5,6,127.0284927,37.52029328,11
포포인츠 바이쉐라톤 서울구로,19,19,126.8988844,37.48317255,38
포포팩토리,8,7,127.5175659,37.82541695,15
포폴로피자 PIZZERIA DEL POPOLO,4,5,126.7730462,37.65854471,9
포피나,5,5,127.0401496,37.54734875,10
포항경주공항,5,5,129.4340775,35.98426914,10
포항고속버스터미널,15,15,129.3676001,36.02805496,30
포항시청 고속버스 간이승강장,3,3,127.150575,36.80777948,6
포항역,15,15,129.3419282,36.07160518,30
폰테베키오,4,4,126.7921977,35.13801242,8
폰트커피 문래점,3,4,126.8925699,37.51224875,7
폴라스튜디오 연남점,4,4,126.926998,37.56194809,8
폴로관광호텔,6,8,126.7352359,37.40094776,14
폴루이트,3,4,126.9854024,37.56966337,7
폴리스 광화문D타워점,3,4,126.9789272,37.57106794,7
폴바셋 AK플라자 홍대점,3,4,126.9264917,37.55773922,7
폴바셋 광교엘포트몰점,4,4,127.0583757,37.2874162,8
폴바셋 광화문점,15,15,126.9789896,37.57478726,30
폴바셋 롯데본점,5,5,126.981788,37.56514888,10
폴바셋 롯데월드몰점,4,4,127.1040841,37.51370957,8
폴바셋 롯데잠실점,5,5,127.0985576,37.51203484,10
폴바셋 송도트리플스트리트점,5,5,126.6607996,37.37980806,10
폴바셋 여의도IFC몰점,8,8,126.9248381,37.52514002,16
폴바셋 용산아이파크몰점,4,4,126.9645327,37.52887074,8
폴바셋 코리아나호텔점,4,4,126.9767378,37.56801586,8
폴바셋 파미에스테이션점,3,2,127.0036371,37.50286403,5
폴스타베이커스,5,5,126.9070011,37.61716666,10
폴스타아트 갤러리,4,4,127.0435445,37.54755478,8
폴콘 김포현대프리미엄아울렛점,4,4,126.7839201,37.59791083,8
폴키,4,4,126.968778,37.57649869,8
퐁당애견펜션,4,4,127.6248001,37.53271034,8
표가네명품순두부,5,5,126.4943399,33.51972565,10
푸당,5,5,126.9019,37.55650501,10
푸드엠파이어 IFC몰점,5,5,126.9259332,37.52507043,10
푸드카페김밥천국 청담2호점,4,4,127.0567429,37.52270859,8
푸라닭치킨 고양원흥점,3,4,126.8763868,37.64899469,7
푸라닭치킨 인천송도랜드마크점,9,9,126.6285863,37.40578583,18
푸라닭치킨 흑석점,2,3,126.9621645,37.50942996,5
푸르내근린공원,3,3,127.1120116,37.32310275,6
푸르메스마트팜 서울농원,5,5,127.1719455,37.68486521,10
푸주옥,10,10,127.2239292,37.36191585,20
푸줏간뒷고기,5,5,127.4903428,37.49120381,10
푸짐한김치감자탕,4,4,127.0056158,37.43645946,8
푸하하크림빵 익선동,5,5,126.9894589,37.57279566,10
풀무질,3,3,126.9973417,37.58439009,6
풀문호텔,12,13,126.5991127,37.47675758,25
풀빌라 림,5,5,127.3954438,37.60167269,10
풀빌라귀족펜션,9,9,127.5031807,37.74422587,18
풀사이드228 송도점,4,4,126.645737,37.39434149,8
풍국면 용산아이파크몰점,3,3,126.9647427,37.52977,6
풍년닭도리탕,5,5,126.9777071,37.56308129,10
풍년쌀농산,3,3,126.9816823,37.58090726,6
풍동 애니골,3,3,127.1444269,35.8199463,6
풍동애니골,5,5,126.789419,37.67174559,10
풍무역 김포골드라인,4,3,126.7324492,37.6124284,7
풍미감자탕,5,5,126.709471,37.46666482,10
풍산역 경의중앙선,4,4,126.7862752,37.67233819,8
풍천가,4,4,127.0726395,37.43083295,8
풍혈산캠핑파크,5,5,127.2953052,38.01421343,10
프라임주유소,5,5,127.2242504,37.92920619,10
프레베리 서오릉,2,2,126.8934174,37.6272255,4
프레지던트호텔,10,10,126.9794146,37.565615,20
프레퍼스다이어트푸드 교대점,5,4,127.0150214,37.49310703,9
프렌즈스크린 진접로얄점,5,5,127.2014494,37.71525341,10
프렌즈키즈풀빌라,4,4,127.318706,38.09241688,8
프렌즈펜션캠핑,6,7,127.3992097,38.07060315,13
프로방스마을,35,39,126.6852386,37.79040523,74
프로방스빌리지,5,5,127.1686359,37.78127012,10
프로방스빌리지제빵소,3,3,127.1685973,37.78125756,6
프로젝트렌트 1호점,4,4,127.0424936,37.54810387,8
프로젝트렌트 6호점,4,4,127.0429676,37.54789737,8
프로젝트씨,9,9,126.6870121,37.34291945,18
프로퍼커피바,5,5,127.1311466,37.50969298,10
프롤라,5,5,127.0609436,37.54126712,10
프롬밀크,11,11,127.5139428,37.82445979,22
프롬하와이 김포라베니체점,12,12,126.6785776,37.63948564,24
프롬헤라스 잠실,5,5,127.1043388,37.5138463,10
프리마리오,4,4,127.0698676,37.54095583,8
프리스비 갤러리아 광교점,5,5,127.0572634,37.2852984,10
프리퍼카페,1,5,127.0749685,37.07167991,6
프린세스호텔,5,5,127.0366499,37.52739454,10
프린스호텔,3,3,128.333689,34.964316,6
프린트베이커리 롯데월드타워점,3,4,127.1025353,37.5125585,7
프릳츠 원서점,8,9,126.9884982,37.57766454,17
플라비,5,5,126.9269252,37.55420758,10
플라워바이네이키드 홍대,1,1,126.9266253,37.55761497,2
플라워북카페,4,4,127.7576239,34.61404547,8
플라워팟,4,4,126.8396118,37.38566847,8
플라워펜션,5,5,127.2188883,37.70100948,10
플라이스테이션코리아,5,5,127.1992079,37.28088992,10
플라이트펍,5,5,126.6986578,37.44579559,10
플라잉수원,35,42,127.0257432,37.28728273,77
플라잉타이거코펜하겐 갤러리아백화점 광교점,4,4,127.0572679,37.28529299,8
플라츠,4,4,126.8942149,37.5135639,8
플라츠2,3,3,127.0605788,37.54068166,6
플랜디,4,4,126.7442047,37.50011839,8
플랜트 이태원,5,5,126.9942299,37.53313766,10
플랫랜드,3,5,126.9151007,37.55650803,8
플러버 강남직영점,5,5,127.0299063,37.4994572,10
플러스마트 가평점,8,9,127.5154383,37.82293877,17
플러스씨어터,9,9,127.0039715,37.58082572,18
플레이 더월드 강남점,5,5,127.0232046,37.50280865,10
플레이가든 홍대점,3,3,126.9175922,37.5498343,6
플레이그라운드 브루어리탭룸 송도점,5,5,126.6490754,37.39623637,10
플레이아쿠아리움 부천,5,5,126.7441338,37.50000291,10
플레이인 더박스 건대점,3,4,127.0675788,37.54120584,7
플레이티카,4,3,127.140518,37.61191283,7
플렉시블커피,4,4,127.0166214,37.59448727,8
플로라늘카페,4,4,127.6045215,37.50973253,8
플로레,10,10,127.4670606,37.78189224,20
플로미니케이크,5,5,126.8992747,37.52932866,10
플로어탑노트,3,3,127.0098353,37.55976191,6
플로티카,5,5,126.9993517,37.53680217,10
플뢰르,4,4,126.8820134,37.63077895,8
플리퍼스 익선점,3,4,126.9901199,37.57308043,7
피규어뮤지엄W,2,2,127.0403869,37.52578593,4
피규어프레소 FP점,5,5,126.9203194,37.5528497,10
피그인더가든 광화문점,5,5,126.9786682,37.57057505,10
피넛호텔,2,2,127.0845111,37.53342832,4
피노키오냉면,5,5,127.0654557,37.66484092,10
피노키오와다빈치,15,17,127.4905532,37.71765206,32
피더블유에이,3,3,127.0594908,37.54269234,6
피멘토,5,5,127.0154816,37.27857597,10
피스피스,4,3,126.7419572,37.71494131,7
피스피스 출판단지점,4,4,126.693268,37.72047738,8
피시지앵 PC방,1,1,126.9456981,37.55723605,2
피아노폭포,8,9,127.3476858,37.6303509,17
피앤티스퀘어,3,3,126.9890924,37.57053593,6
피양옥,5,5,127.0483199,37.51945791,10
피에스비,5,8,127.0435087,37.54818729,13
피오니 연남점,9,9,126.9199451,37.56443298,18
피오니 홍대점,8,9,126.9197658,37.55008538,17
피오리,2,3,126.912433,37.55472751,5
피우리하우스,8,9,126.8748391,37.80186172,17
피자덕후 피자힙,20,19,127.0379446,37.52610659,39
피자레볼루션 이태원점,2,2,126.9954924,37.53435226,4
피자몰 반포뉴코아아울렛점,5,5,127.0074694,37.50917539,10
피자몰 신촌점,4,4,126.9359804,37.55512285,8
피자스쿨 고양향동점,3,3,126.8916261,37.6017259,6
피자스토어 삼송점,4,4,126.492769,33.50707896,8
피자알볼로 동백점,5,5,127.1520727,37.27133856,10
피자오 현대프리미엄 아울렛 다산점,4,4,127.1524099,37.61624624,8
피자원 동탄점,4,5,127.06784,37.21011596,9
피제리아라고,5,5,127.1058815,37.50894797,10
피제리아스텔라레,2,3,126.6970287,37.78764496,5
피치스 도원,10,9,127.0513845,37.54442516,19
피치스프링스,3,3,126.7819261,37.66956602,6
피카소거리,5,5,126.921956,37.5507716,10
피커스 구로점,4,4,126.8827413,37.50110479,8
피클피클익스프레스,4,4,127.007765,37.56770885,8
픽닷,7,6,127.0436348,37.54715651,13
픽셀퍼인치,4,4,126.9720558,37.53283897,8
픽커스 망원점,5,5,126.9051844,37.55464263,10
핀즈,5,5,127.0482306,37.54241907,10
핀치,10,10,126.9680874,37.57931141,20
필라델피아,10,10,127.040005,37.52562093,20
필룩스조명박물관,21,22,126.9675465,37.83613579,43
필름로그,3,3,127.0043509,37.56422578,6
필름로그 강남직영점,4,4,127.0267617,37.50058331,8
필름포럼,4,5,126.944068,37.56376572,9
필립테이블,3,4,126.9052091,37.70288549,7
필무드,5,5,126.91197,37.7764819,10
필스테이 이화부띠끄점,3,3,126.9452941,37.55882883,6
필커피,2,3,127.0020293,37.26497575,5
핏제리아 루카 본점,6,7,127.6016542,37.51802728,13
핏제리아루카,4,4,128.7216585,36.56130245,8
핏제리아루카 본점,5,5,126.3097228,33.46327185,10
핏제리아오 동부이촌점,5,5,126.96772,37.5201986,10
핏크,5,5,126.916286,37.56118685,10
핑크버스 김포점,5,5,126.6796057,37.64018219,10
핑크엘리펀트,2,2,126.9221599,37.5505591,4
하계역 7호선,10,10,127.0679913,37.63647654,20
하나로마트 삼송점,6,6,126.898869,37.64862688,12
하나로마트 수원점,4,4,126.9668789,37.28298474,8
하나은행365 남대문E동지하수입상가,3,3,126.9776494,37.55919258,6
하나키즈풀빌라,2,3,127.3603608,37.7635224,5
하남 아이스링크,5,5,127.1886697,37.55752307,10
하남ICEBOX,5,5,127.2006006,37.56169753,10
하남검단산역 5호선,5,5,127.2232193,37.53980326,10
하남나무고아원,12,13,127.1955141,37.58160451,25
하남농협하나로마트,4,4,127.1962155,37.56973367,8
하남돼지집 남영점,4,4,126.97345,37.54125013,8
하남돼지집 대학로점,3,4,127.0026402,37.58299535,7
하남돼지집 송도센트럴파크점,5,5,126.6450073,37.39223812,10
하남드림휴게소,13,11,127.2061235,37.53033421,24
하남만남의광장충전소,4,4,127.2086688,37.53104693,8
하남만남의광장휴게소 주차장,5,5,127.2061676,37.53073237,10
하남만남의광장휴게소주유소 통영방향,5,5,127.2069847,37.53080843,10
하남만남주유소,3,2,127.2747841,36.49127152,5
하남어시장,5,5,127.2023255,37.57008555,10
하남역사박물관,16,17,127.2060792,37.54548548,33
하남위례길 제2코스(위례강변길),4,5,127.2146521,37.56127729,9
하남유니온타워,23,25,127.2203921,37.54722919,48
하남유니온파크,8,7,127.2194811,37.54681643,15
하남이성산성,5,5,127.185208,37.52521153,10
하남풍산역 5호선,5,5,127.2040066,37.5522898,10
하노,2,3,126.9235599,37.56376323,5
하노이별,3,2,126.6571164,37.45219848,5
하노이의아침,4,4,126.9444162,37.5644218,8
하누가,4,4,126.9806849,37.48016072,8
하늘공원,72,73,126.8819415,37.56797554,145
하늘공원 메타세콰이어길,15,15,126.8834432,37.56534683,30
하늘공원 하늘계단,4,4,126.891035,37.56594513,8
하늘궁,3,3,126.9483545,37.74853027,6
하늘능선근린공원,3,3,127.10615,37.74504488,6
하늘도화지펜션,6,6,127.3781773,38.0467588,12
하늘땅별땅,2,2,127.48329,37.76181564,4
하늘땅별땅쉼터캠핑장,5,5,127.5329177,37.95157696,10
하늘숲글램핑파크,5,5,127.5621025,37.9045009,10
하늘에바다에,4,4,126.5726571,37.28611315,8
하늘정원 주차장,10,10,126.4733033,37.44452144,20
하늘천따지,10,10,127.6644069,37.29123783,20
하늘초밥,10,10,126.946694,37.55730859,20
하늘향기풀빌라,3,4,127.3513578,37.96052891,7
하니랜드,4,4,126.8361001,37.75034849,8
하니칼국수,4,5,127.0171709,37.56616716,9
하동관 명동본점,3,2,126.9850231,37.56443034,5
하동관 여의도역점,5,5,126.9256512,37.52180493,10
하동관 코엑스몰직영점,1,2,127.0588209,37.51252263,3
하드림해물칼국수,5,5,127.163994,37.77192648,10
하디르,8,9,126.7823631,37.67170035,17
하렌풀빌라,3,4,127.31972,37.78293194,7
하루,4,4,126.691575,37.78678571,8
하루엔소쿠 상도점,4,4,126.9444783,37.49895148,8
하루엔소쿠 시흥플랑드르점,3,3,126.8073689,37.37080572,6
하루필름 강남역점,5,5,127.0277488,37.50308788,10
하루필름 건대점,5,5,127.0686283,37.541799,10
하루필름 서울숲점,4,4,127.0436005,37.54644653,8
하루필름 성수점,2,2,127.0514541,37.54373587,4
하루필름 수원행궁2호점,10,10,127.0142877,37.28537446,20
하루필름 연남점,5,5,126.926725,37.56215425,10
하루필름 영등포점,3,4,126.5212418,33.51258377,7
하루필름 행궁점,2,4,127.0111526,37.28479813,6
하림옛날통닭,5,5,126.9920814,37.56499685,10
하마씨어터,5,5,127.0027715,37.58226014,10
하백 북한강점,5,5,127.3432444,37.61517783,10
하버뷰호텔,3,3,126.6009793,37.47738018,6
하버커피,5,5,127.3565673,37.62936936,10
하삼동커피 배곧신도시점,3,3,126.7141248,37.36384501,6
하센영인호텔,4,4,126.9932186,37.55650953,8
하스,4,4,126.9254144,37.55985589,8
하야시,4,4,129.0309715,35.09870945,8
하얀나무,2,3,127.418077,37.47551228,5
하얀풍차제과 매탄점,7,8,127.0378533,37.26626001,15
하연옥 마포점,5,5,126.9172594,37.55503913,10
하연옥 본점,3,3,128.0606862,35.19390014,6
하오호텔,3,3,127.1100049,37.51569002,6
하우스바이콘반,5,5,126.9804752,37.47787032,10
하우스베이커리,11,15,127.3532824,37.59879262,26
하우스웨더,4,5,128.6488807,35.88510367,9
하우스커피,4,4,127.1726949,37.65405784,8
하우스플랜비,4,5,127.0115314,37.28399527,9
하우스플랜트,8,8,127.199439,37.5471439,16
하우패스,3,3,126.9344516,37.47083849,6
하우현성당,4,4,127.0235397,37.39585373,8
하울즈,5,5,127.0790487,37.24948658,10
하이그라운드제빵소,10,10,127.007371,37.67028725,20
하이도나,15,15,127.0018637,37.45377347,30
하이드,4,4,127.1501715,37.27400987,8
하이드파크,3,4,127.109836,37.27005715,7
하이디라오 강남점,5,5,127.0248014,37.50256415,10
하이디라오 명동점,17,17,126.9837348,37.56533837,34
하이디라오 영등포점,5,5,126.9092543,37.516975,10
하이디라오 홍대지점,5,4,126.9247606,37.55719213,9
하이브로우컴퍼니,4,5,127.3796293,37.59495551,9
하이브인사이트,2,2,126.9639918,37.52453495,4
하이서울유스호스텔,17,18,126.9032245,37.525591,35
하이스트리트게스트하우스,4,4,126.9221589,37.56026464,8
하이스트리트이탈리아,5,5,127.0223804,37.52255431,10
하이시리얼,7,9,127.0145072,37.28329754,16
하이오션 경포,9,9,128.9035067,37.80391763,18
하이웨이디씨클럽 수원정자점,5,5,127.0085554,37.29278695,10
하이커그라운드,19,19,126.9814182,37.56857531,38
하이클래스,5,5,126.6048096,37.22157629,10
하이트모텔,2,2,127.300226,38.00898192,4
하이패스센터,3,3,127.1025063,37.3696279,6
하이팰리스 풀빌라펜션,10,10,127.5107162,37.70270502,20
하이프,2,4,126.9888104,37.53387609,6
하이프라이데이,3,2,126.9245891,37.55890932,5
하초동,5,5,128.0786035,36.75554666,10
하쿠,14,14,127.0142674,37.28536095,28
하탐베이커리카페,5,4,127.2483324,37.54444642,9
하파크리스틴 팝업,5,5,126.9084,33.45607516,10
하프커피 강남파미에스테이션점,5,5,127.0045577,37.5034046,10
하피랜드,4,4,126.8885253,37.16856511,8
학고재,5,5,126.9804553,37.58024754,10
학곡리막국수닭갈비,5,5,127.753035,37.85031722,10
학동근린공원,4,3,127.0252185,37.51550069,7
학림다방,18,18,127.0016574,37.58195022,36
학미산,3,3,126.7805747,37.40710264,6
한 끼 갈비탕,5,5,126.6603544,37.38214944,10
한강,51,51,126.9475451,37.52508922,102
한강3경 이포보,4,5,127.5390048,37.40475135,9
한강3경 이포보전망대,5,5,127.543744,37.40537478,10
한강공원삼패지구,17,16,127.1951209,37.59230534,33
한강공원압구정나들목 진출입로2,5,5,127.0419508,37.53060755,10
한강공원옥수역하부경사로 진출입로,4,4,127.0188555,37.54081282,8
한강껍데기,2,3,126.90228,37.55667831,5
한강남자전거길,5,5,126.8359853,33.32539201,10
한강달빛야시장,2,3,126.997434,37.5117154,5
한강문화관,5,5,127.6800337,37.27779233,10
한강뮤지엄,5,5,127.2366954,37.55339829,10
한강신도시호수공원 호수,4,4,126.6352575,37.64617468,8
한강중앙공원,23,23,126.6748058,37.64338917,46
한강진역 6호선,20,20,127.0017651,37.53979077,40
한경대정류소,13,13,127.2635834,37.00983046,26
한고집,3,4,126.7866707,37.64662853,7
한국SGI 이케다기념강당,5,5,126.890159,37.50262201,10
한국계 방이직영점,5,5,127.107965,37.51454583,10
한국관,4,4,126.9773946,37.56348488,8
한국근대문학관,3,4,126.6211037,37.47255578,7
한국근현대사박물관,10,12,126.695182,37.79086743,22
한국기독교 100주년기념교회,4,4,126.9117636,37.5464991,8
한국기독교100주년기념탑,3,3,126.6165052,37.47338428,6
한국대중음악박물관 서울점,5,5,127.1039161,37.51328805,10
한국도자재단 경기도자박물관,12,11,127.3266382,37.35116117,23
한국만화박물관,8,9,126.7421398,37.50863018,17
한국민속촌,151,151,127.1197996,37.25960982,302
한국민속촌 놀이마을,3,3,127.1196791,37.25758079,6
한국민속촌 자동차극장,10,10,127.1144237,37.25751481,20
한국민속촌 장터,3,3,127.1198039,37.25950169,6
한국에서두번째양평해장국,5,5,127.378316,37.68437295,10
한국예술문화센터,5,4,126.9870004,37.57144392,9
한국은행 경기본부,3,3,127.0095855,37.28701843,6
한국은행 본부,7,7,126.9797446,37.56256989,14
한국은행 화폐박물관,7,13,126.9805234,37.5620979,20
한국의집 롯데월드몰점,5,5,127.1034847,37.51376596,10
한국이민사박물관,15,18,126.6001891,37.47014785,33
한국이슬람교 서울중앙성원,7,9,126.9975788,37.53340087,16
한국인의밥상,5,6,126.9890953,37.20739479,11
한국잡월드,8,8,127.106286,37.37848344,16
한국초콜릿연구소뮤지엄,5,5,127.3784013,37.6897713,10
한길 북하우스,3,3,126.6980922,37.78936853,6
한길순대,5,5,127.0250068,37.2563087,10
한나식빵,4,4,126.2688959,33.31879223,8
한남동 골목,5,4,127.0062454,37.5311789,9
한남동 카페거리,8,7,127.0015886,37.53696884,15
한남동그집 한남동점,3,3,127.0057928,37.5331737,6
한남북엇국,5,5,127.0080737,37.53393401,10
한내근린공원,5,5,126.8862063,37.45124993,10
한담,5,5,126.9699346,37.52961286,10
한대앞역 4호선,5,4,126.8540232,37.30942948,9
한동길감자탕,3,3,127.0700558,37.63917829,6
한라비발디캠퍼스2차아파트,20,20,126.7152185,37.36237177,40
한마당오리,5,5,126.5828651,37.26154142,10
한방순대국,5,5,127.1166343,37.27723013,10
한방전주콩나물국밥,5,3,126.8728267,37.29382452,8
한방전주콩나물국밥 정왕1호점,4,4,126.7235305,37.35425163,8
한방전주콩나물국밥 초지점,5,5,126.8153407,37.30940428,10
한복남 경복궁점,6,8,126.9733074,37.57620788,14
한샘디자인파크 하남스타필드점,3,3,127.2237126,37.54545339,6
한샘식자재할인마트,5,4,126.8036181,37.34237396,9
한성백제박물관,3,3,127.120895,37.51541268,6
한성칼국수,5,5,127.0091866,37.45629597,10
한성컴퓨터 서울직영서비스센터 마곡본사,5,5,126.8388114,37.56403113,10
한송칼국수낙지,5,5,127.1309321,37.65601806,10
한솥도시락 의정부회룡점,4,5,127.0443279,37.72359801,9
한순자손칼국수집,3,3,126.9773192,37.55840865,6
한스 수지점,4,4,127.0943407,37.32091963,8
한식당대화,5,5,126.7480667,37.66842099,10
한식문화공간이음,10,10,126.9858399,37.57841028,20
한신2차아파트,3,3,127.0447968,37.72622506,6
한신포차 연신내점,5,5,126.9191895,37.61954793,10
한아름공원,6,6,126.7510609,37.49647856,12
한암동 여의도점,5,5,126.924138,37.52386015,10
한양2차아파트,4,4,126.6725525,37.40544724,8
한양대학교 ERICA캠퍼스,3,3,126.835175,37.29643343,6
한양대학교 동문회관,4,4,127.0416908,37.55955494,8
한양도성박물관,5,5,127.0085443,37.57294719,10
한옥기술전시관,14,14,127.0149183,37.2867746,28
한옥카페 카르폰,5,5,126.5930415,37.23574046,10
한옥카페소원,5,5,126.6963308,37.78979285,10
한옥펜션수진당,5,5,127.2343849,37.18483899,10
한우강국,3,3,126.8841595,37.11282583,6
한우등심전문돌판구이,2,4,126.648993,37.3955045,6
한우리 신세계본점,4,4,126.9810987,37.56096274,8
한울공원 해수풀장,9,9,126.701805,37.35402045,18
한일유앤아이아파트,5,5,126.8759905,37.48627904,10
한입소반,6,6,126.9703078,37.54409924,12
한잔뭔말인지알지,4,5,126.8925085,37.53933822,9
한전아트센터,5,5,127.0286741,37.48592888,10
한주당,4,3,126.9237437,37.55108632,7
"한중문화관, 화교역사관, 인천 박물관 거리",3,3,126.6187537,37.4735485,6
한중원,3,3,126.6188219,37.47398644,6
한집맛고기,4,4,126.8285265,37.33167241,8
한촌설렁탕 오산점,4,4,127.0742749,37.14912421,8
한탄강 주상절리길 주차장,5,5,127.3003382,38.17406933,10
한탄강 지질공원센터,17,19,127.2249973,38.07326039,36
한탄강은하수교,3,3,127.2784592,38.20062587,6
한탄강지오카페,10,10,127.125558,38.06716892,20
한탄강지질공원,4,4,127.2869749,38.18583246,8
한탄강하늘다리,37,37,127.2191422,38.0841392,74
한탄임진강지질공원,4,4,127.2178278,38.07983166,8
한택식물원,7,8,127.4065802,37.09457049,15
한터보리 수내점,5,5,127.1158785,37.37990165,10
한터시골농장,3,3,127.280392,37.26137207,6
한화리조트 산정호수 안시,3,3,127.3141202,38.06610452,6
한화리조트 산정호수안시,7,7,127.3139588,38.06620405,14
한화리조트 용인베잔송,24,25,127.1441266,37.13166128,49
한희수개성만두요리전문점,5,5,127.3025991,36.4900219,10
할랄가이즈 홍대점,5,5,126.9233122,37.55693531,10
할리데이비슨코리아 용인점,4,4,127.1019186,37.28143265,8
할리스 광화문점,7,7,126.9759712,37.56901671,14
할리스 구로디지털역점,2,1,126.9012569,37.48457202,3
할리스 김포공항점,5,5,126.8030149,37.55895558,10
할리스 김포한강생태공원점,5,5,126.6982413,37.65367576,10
할리스 대명거리점,5,5,127.001114,37.5837423,10
할리스 동탄카림애비뉴점,5,5,127.1135119,37.19818173,10
할리스 부천송내본점,3,3,126.752909,37.49022226,6
할리스 세로수길점,3,3,127.0226822,37.51822944,6
할리스 신림역점,3,3,126.9297156,37.48221192,6
할리스 신림점,5,5,126.929287,37.48594003,10
할리스 을지로입구점,4,4,126.9834294,37.56476169,8
할리스 이태원점,4,4,126.9942286,37.53468738,8
할리스 인천한옥마을점,7,8,126.6390001,37.3909441,15
할리스 충정래미안점,3,3,126.9661959,37.55877539,6
할리스 평촌점,4,4,126.9630587,37.39310399,8
할리스 합정역점,4,4,126.9133896,37.54855999,8
할리스 홍대거리점,5,5,126.9216595,37.55181927,10
할리스 홍대역점,3,3,126.9227598,37.55484104,6
할리스 화성병점점,5,5,127.0394941,37.21319148,10
할매춘천닭갈비,7,7,127.5224877,37.81078545,14
할머니 포장마차멸치국수,4,4,127.1135968,37.51526855,8
할머니고향순두부,5,4,127.0189978,38.05849372,9
할머니네집,5,5,127.0158247,37.28558961,10
할머니댁,20,20,126.3190282,33.37594688,40
할머니손두부,1,1,127.3489405,37.86510958,2
할머니손순대,5,5,127.5154432,37.8305076,10
함박웃음식당,4,4,127.0041888,37.58055542,8
함반,3,3,126.9100349,37.54906023,6
함지박,5,5,127.4544112,37.77090678,10
함지박손칼국수,3,4,126.9507988,37.31072388,7
함평역,4,4,126.5387342,35.02393589,8
함흥관,3,3,126.642287,37.46202056,6
합정고깃집,2,2,126.9104552,37.54959575,4
합정광안리 2호점,3,4,126.9179097,37.55029133,7
합정역 2호선,13,13,126.9144541,37.54991316,26
합정역 6호선,10,10,126.9142132,37.54878403,20
합정옥,3,3,126.9104597,37.54958133,6
합정티라미수,5,5,126.9108874,37.5513043,10
합천돼지국밥,5,5,126.9519644,37.54187494,10
핫쵸,4,4,127.0235439,37.52090615,8
항동저수지,4,4,126.8230533,37.48369871,8
항아리갈비탕 포천직영점,3,3,127.1840347,37.87648969,6
항아리매운탕 본점,5,5,127.1938809,37.89713257,10
항아리손칼국수,5,5,127.2618056,38.02513992,10
항일운동기념탑,3,3,127.1880161,37.4766105,6
항정사이,5,5,126.9078659,37.51744515,10
해남닭집,2,2,127.0699983,37.54398312,4
해남식당,4,4,127.0192288,37.56666059,8
해돋이공원,3,3,126.6544857,37.38771065,6
해든복권나라,4,4,126.7743477,37.50083574,8
해머스미스커피 압구정역점,2,3,127.0279248,37.52614273,5
해목,9,9,127.0382918,37.52152489,18
해물맛있찜,4,4,127.3242772,37.54259634,8
해민면옥,5,5,126.7231539,37.49469194,10
해밀,4,4,127.2092705,37.521261,8
해밀칼국수&김밥,5,5,127.0557833,37.54352036,10
해밀톤호텔,18,18,126.9935577,37.53482159,36
해밀펜션,4,4,127.5409743,37.75705929,8
해밀한옥게스트하우스,3,4,126.991522,37.576743,7
해밀호텔,27,27,127.017822,37.2813148,54
해바라기펜션,3,3,127.4744957,37.95375147,6
해바라기펜션_바베큐,3,3,127.4744957,37.95375147,6
해바라기펜션_족구,3,3,127.4744957,37.95375147,6
해방촌 칵테일바 헤엄,3,4,126.986422,37.53993056,7
해방촌성당,4,4,126.9839455,37.54347298,8
해방촌아름이,3,3,126.9837862,37.54749142,6
해방촌예술마을,5,4,126.981727,37.54625495,9
해방촌오거리,9,8,126.9852781,37.54590405,17
해방촌오거리.이태원클라스 촬영지,3,4,126.9853075,37.54581215,7
해솔마을2단지월드메르디앙아파트,6,6,126.7442363,37.72632733,12
해솔마을6단지휴먼시아아파트,5,3,126.7471698,37.72262347,8
해솔마을7단지롯데캐슬아파트 후문,4,3,126.749478,37.72061743,7
해솔제빵소,5,5,126.666266,37.17513076,10
해송 곤지암점,2,2,127.3380255,37.32630049,4
해슬리나인브릿지CC,29,29,127.6176348,37.2506602,58
해승리시골밥상,3,3,127.6085015,37.25345834,6
해양경찰청,3,3,126.6490728,37.39341978,6
해여림빌리지 캠핑장,4,4,127.4373457,37.39087379,8
해오라기어린이공원,3,3,127.0763307,37.6254664,6
해와달,13,13,127.2059862,37.43131912,26
해와달한복,10,10,126.8268244,36.21521072,20
해우재,4,8,126.9779215,37.31909905,12
해우재문화센터,4,6,126.9779013,37.31867556,10
해운대시외버스정류소,3,3,129.1606087,35.1651656,6
해울한정식,3,4,126.6983319,37.72645486,7
해자연캠핑장,12,12,127.2640999,37.70173407,24
해장촌,3,3,126.989208,37.20707403,6
해적마트,5,5,126.9936641,37.53387375,10
해찬솔공원,4,4,126.6676294,37.38851869,8
해품가 바다를품은횟집,4,4,126.6179737,37.16421825,8
해피니스디저트 건대점,5,5,127.0674188,37.53940393,10
해피리본소사이어티,5,5,126.9189549,37.39994056,10
해피베어데이,3,4,126.9212207,37.54833842,7
해피스페이스24,2,2,127.1096119,37.51613728,4
해피씨어터,10,10,127.0025722,37.58189254,20
해피주 동물카페 영통점,2,3,127.075662,37.25320199,5
해피초원목장,4,5,127.6958067,37.97924947,9
해피클럽,8,8,126.9954995,37.56721708,16
해피토스트,5,5,128.997215,35.20601998,10
핵인싸코인노래방,5,5,127.002124,37.50575179,10
핵커피 청계다동점,4,3,126.981622,37.56821764,7
핸콕커피앤바,3,3,126.6883454,37.34254093,6
햇살들귀농교육원,5,5,126.8670892,37.02721248,10
행2pm8pm 와인바,3,3,126.99073,37.56399664,6
행궁81.2,25,25,127.0140871,37.28610252,50
행궁그로서리,3,3,127.1057213,37.51008969,6
행궁그리다,2,2,127.0143292,37.28443287,4
행궁길갤러리,2,2,127.0146848,37.28079803,4
행궁까롱,5,5,127.0172289,37.28161944,10
행궁다과,8,8,127.0149238,37.28031505,16
행궁동벽화마을,75,78,127.0169243,37.28598321,153
행궁만두,5,5,127.014917,37.28031865,10
행궁빙수,16,16,127.0134761,37.28770014,32
행궁식탁,5,5,127.0112902,37.28482875,10
행궁통닭,2,3,127.018236,37.2794305,5
행궁통닭본닭강정,5,5,127.0182399,37.2794631,10
행궁파티,13,13,127.0108754,37.28591545,26
행궁호두,6,7,127.0119431,37.28451873,13
행담도휴게소 양방향,2,2,126.8075128,36.94476099,4
행리단길,163,166,127.0134627,37.2914853,329
"행리단길, 화성행궁광장",4,4,126.8446725,33.32144142,8
행복빵집 과천점,5,5,126.9928731,37.42806911,10
행복추풍령감자탕 평촌역점,3,4,126.9631851,37.39330586,7
행복한찹쌀꽈배기,3,3,127.3652648,37.35152935,6
행복한콩박사,4,4,127.0289553,37.19381471,8
행복한흙집,5,5,127.4531458,37.61909115,10
행복한흙집앞 계곡,5,5,127.4531458,37.61909115,10
행신역,21,21,126.8342897,37.61197114,42
행운약국,5,5,126.7256983,37.49156418,10
행주국수,5,3,126.8272056,37.60110497,8
행주나루터,5,5,126.8143759,37.59995745,10
행주대교,2,2,126.8093408,37.59742305,4
행주산성,17,17,126.8287096,37.59610126,34
행주산성 매표소,3,3,126.8248033,37.59985806,6
행주산성공원,4,4,126.8199064,37.5981316,8
행주산성역사공원,20,21,126.8191385,37.59726187,41
행주산성원조국수집,4,4,126.8275759,37.60162268,8
행주성당,4,4,126.8168163,37.60223536,8
행카페,4,4,127.0122782,37.28549813,8
향남힐링스파,14,14,126.9229903,37.13306917,28
향유갈비,5,5,127.3643779,38.03279669,10
향촌,3,3,127.7478186,34.73298772,6
허기숙할머니원조오뎅식당 별관,3,3,127.049437,37.74444082,6
허난설헌생가터,5,5,128.9095815,37.7918634,10
허니시티,1,1,127.45956,37.77465281,2
허니즉석떡볶이 광화문본점,8,8,126.9761066,37.5705232,16
허닛,4,4,127.0373319,37.50198421,8
허머스키친 삼성점,4,4,127.060809,37.50919151,8
허브식당,3,3,127.8155813,36.51740418,6
허브아일랜드,87,94,127.16011,37.90485792,181
허브아일랜드 가든,5,5,127.130765,37.96547928,10
허브아일랜드 불빛동화축제,5,4,127.1317617,37.96536645,9
허브아일랜드 산타마을,9,9,127.1303922,37.96570313,18
허브아일랜드 아테네홀 레스토랑,16,17,127.1307577,37.96647753,33
허브아일랜드 한탄강점,13,13,127.2247457,38.07337258,26
허브아일랜드 허브박물관,4,3,127.1309738,37.96513309,7
허브와풍뎅이,4,4,127.4422945,37.04939486,8
허브힐링센터,5,5,127.1316662,37.96538818,10
허수아비 돈까스카레전문점 정동점,5,5,126.9694698,37.56790879,10
헌혈의집 동탄센터,5,5,127.0728172,37.20665568,10
헌혈의집 주안센터,5,5,126.6804967,37.46085962,10
헤르메스호텔,18,19,127.2127852,37.26173532,37
헤르지아,2,2,126.9854773,37.55682598,4
헤르츠커피로스팅,4,4,127.0809208,37.5592904,8
헤리티지클럽,5,5,126.9924733,37.57376806,10
헤미안,10,10,126.9875648,37.53985861,20
헤븐센스 성수연무장점,12,14,127.052798,37.54311809,26
헤비스테이크 성수점,3,3,127.0534824,37.54285829,6
헤비스테이크 안국역점,13,13,126.9863745,37.57738681,26
헤비스테이크 여의도점,4,3,126.9208554,37.52991813,7
헤세드스시,3,3,126.7266748,37.49357388,6
헤올커피로스터즈,5,5,127.0147619,37.28851903,10
헤이 미니샵,4,4,127.0952428,37.16654288,8
헤이러브,3,3,127.0720032,37.5437044,6
헤이리농원,13,13,126.707883,37.80031282,26
헤이리무장애노을숲길,9,9,126.7002894,37.79152202,18
헤이리예술마을,135,137,126.6989531,37.78817425,272
헤이스윗,5,5,127.0057194,37.58054454,10
헤키,5,5,126.9079218,37.55571698,10
헬로apm,4,4,127.0081407,37.56749079,8
헬로오드리,5,5,127.0470334,37.37994546,10
헬로우가든마켓,5,5,126.9002771,37.66674862,10
헬카페스피리터스,5,5,126.9753492,37.51931025,10
현대그린마트,4,5,127.2193791,37.5402087,9
현대드림마트,5,5,126.7659246,37.66719641,10
현대모터스튜디오 고양,22,23,126.7474937,37.66627183,45
현대모터스튜디오 서울,13,13,126.8725363,36.1853729,26
현대모터스튜디오고양 키친바이해비치,3,4,126.7474983,37.66623941,7
현대백화점 디큐브시티점,23,21,126.8895806,37.5091042,44
현대백화점 목동점,5,5,126.8752585,37.52665409,10
현대백화점 무역센터점,29,29,127.0597748,37.50865144,58
현대백화점 미아점,5,5,127.0287483,37.60848273,10
현대백화점 신촌점,30,29,126.9358165,37.5561535,59
현대백화점 압구정본점,21,21,127.0274705,37.5273718,42
현대백화점 중동점,17,17,126.7618391,37.50427465,34
현대백화점 중동점 쇼핑 및 식사,4,4,126.7618391,37.50427465,8
현대백화점 천호점,3,3,127.1244433,37.53884197,6
현대백화점 킨텍스점,5,4,126.7511811,37.66818614,9
현대백화점 판교점,69,71,127.1120475,37.39279718,140
현대백화점면세점 동대문점,3,3,127.0089899,37.56908819,6
현대백화점유플렉스 디큐브시티,3,3,126.8895021,37.50865542,6
현대백화점유플렉스 신촌점,18,17,126.9366173,37.55673778,35
현대백화점유플렉스 중동점,4,4,126.7611135,37.5044714,8
현대세탁음료,7,8,127.7488111,35.51620626,15
현대시티아울렛 가산점,10,10,126.8890469,37.4776919,20
현대시티아울렛 동대문점,33,34,127.0076972,37.56878104,67
현대썬앤빌오피스텔,16,15,126.8973477,37.65318815,31
현대장칼국수 양평점,3,3,127.4955775,37.49453548,6
현대카드 디자인 라이브러리,7,8,126.9839921,37.57975432,15
현대카드 바이닐앤플라스틱,4,4,126.498094,37.61711169,8
현대카드 바이닐앤플라스틱 (KHEE 소주 팝업스토어),4,4,126.3127147,33.23668384,8
현대카드 바이닐앤플라스틱 (발렌티노뷰티 팝업),4,4,126.4230635,37.63397553,8
현대카드 바이닐앤플라스틱 (배달의 민족 팝업스토어),4,4,126.4559477,37.59380847,8
현대카드 아트라이브러리,4,4,127.0008644,37.53681028,8
현대카드 쿠킹라이브러리,5,4,127.0356535,37.5256469,9
현대프리미엄아울렛 김포점,118,120,126.7855783,37.59932841,238
현대프리미엄아울렛 김포점 회전목마,4,4,126.7855783,37.59932841,8
현대프리미엄아울렛 송도점,159,162,126.6579049,37.38173782,321
현대프리미엄아울렛 스페이스원,88,93,127.1524791,37.61630471,181
현대힐스테이트아파트 서문,5,5,127.0372401,37.27114204,10
현리양평해장국,2,4,127.3432428,37.8235349,6
현선이네 용산본점,5,5,126.9692495,37.53113357,10
현우동,5,5,127.0242881,37.51700736,10
현풍닭칼국수 하남점,5,5,127.2081718,37.55248075,10
형제들감자탕,4,4,126.8449141,37.33995491,8
형제분식,3,4,126.9771042,37.55830049,7
형제육회 본점,1,1,127.0000724,37.57064095,2
형제칼국수,5,5,128.8930945,37.75787962,10
형제특수부위,3,3,126.951075,37.54191422,6
혜리별관,10,9,126.705547,37.44572466,19
혜민당,4,4,126.9886131,37.5664778,8
혜밀버거레시피,9,9,126.6978076,37.78844161,18
혜성,4,2,127.1138677,37.51118134,6
혜화곱창,12,12,127.0006476,37.58269986,24
혜화도담,6,8,127.0004347,37.58302421,14
혜화돌쇠아저씨,5,5,127.001345,37.58281157,10
혜화동돈까스극장 김포장기점,4,4,126.679528,37.6413911,8
혜화동버거,5,5,127.0047187,37.58112843,10
혜화몰트,4,4,127.0026651,37.58414953,8
혜화문,9,9,127.003836,37.58790393,18
혜화역 4호선,40,40,127.001945,37.58204392,80
호계동성당,5,4,126.9549353,37.37310565,9
호계시외버스정류장,4,4,126.950863,37.38532552,8
호계식 망원점,3,3,126.9067398,37.55250129,6
호계체육관,5,5,126.9469099,37.38022762,10
호구포역 수인분당선,3,3,126.7086832,37.40164217,6
호남제일문 버스하차장,7,7,127.0686738,35.87032882,14
호남제일문 시외버스매표소,17,17,127.0713727,35.86961616,34
호랑이,5,5,126.9954497,37.56746575,10
호랑이면,1,2,126.9569118,37.47812898,3
호랑이캠핑 포천점,5,5,127.3251221,38.05569424,10
호랭이족발 별내점,4,4,127.1142915,37.65022582,8
호롤커피,9,9,127.0989002,37.50511574,18
호맥 연남점,5,5,126.9243733,37.55965701,10
호맥 평택역점,4,4,127.0914793,36.99178152,8
호메오,3,4,126.6979155,37.78870497,7
호명산,3,4,127.4457673,37.72952533,7
호명산 두레펜션 캠핑장,5,5,127.4700414,37.76859308,10
호명산잣나무숲속캠핑장,15,15,127.4590534,37.76577495,30
호명산잣나무숲속캠핑장 인근,5,5,127.4590534,37.76577495,10
호명호수,18,18,127.4752976,37.74858873,36
호명호수공원,3,3,127.4660717,37.76052815,6
호미스,4,4,127.014087,37.2857349,8
호미호식,6,8,127.0268438,37.50249703,14
호박식당 본점,4,4,127.0123226,37.55730916,8
호반베르디움더프라임아파트,9,9,126.8621915,37.38403906,18
호반전망대,3,3,128.0325239,35.1765861,6
호복,3,3,126.9377811,37.55762678,6
호수가의아침,9,9,127.2772441,37.97444901,18
호수공원 놀이터,5,5,127.7416623,34.73795689,10
호수공원 식물원 수피아,4,5,127.7357611,34.74024527,9
호수산장캠핑장,3,3,127.541741,37.23226141,6
호수식당,5,5,127.0551281,37.90916549,10
호수앉기,8,8,127.1004516,37.24155107,16
호수정감,7,7,127.258764,37.13451476,14
호수집 원조닭꼬치,4,4,126.9686812,37.5590608,8
호스텔베네 롯데타워점,8,5,127.1101047,37.51586652,13
호암미술관,10,10,127.1916289,37.29454414,20
호암미술관 전통정원희원,8,8,127.1907585,37.29465727,16
호우섬 더현대서울점,16,15,126.9283161,37.52578459,31
호운,9,9,127.3743676,37.30495563,18
호원가든,3,4,127.5524041,37.8430866,7
호작도,9,8,127.0164417,37.28632027,17
호천당 김포구래점,4,5,126.6291173,37.64638709,9
호치킨 마포도화점,3,3,126.9516701,37.54200817,6
호치킨 선유도역점,3,5,126.8945247,37.53776869,8
호텔 GMS,11,11,126.909005,37.51749739,22
호텔 U5,5,5,127.0018597,37.56739735,10
호텔 꼬뮨,5,5,127.2487785,37.8042612,10
호텔 나루 서울 엠갤러리,4,4,126.944218,37.53723769,8
호텔 동양장,13,13,127.0177814,37.57284164,26
호텔 레인보우,8,8,126.6788234,37.46044783,16
호텔 미드시티 명동,4,4,126.9810155,37.56763821,8
호텔 베르누이 서울,3,3,126.8459716,37.49743512,6
호텔 스카이파크 킹스타운 동대문점,54,54,127.00767,37.56871257,108
호텔 카누,4,4,127.4077494,37.29884627,8
호텔28,5,5,126.7405283,37.38978684,10
호텔AMA,4,4,126.917301,37.41682814,8
호텔IMT,5,5,127.1022656,37.32534523,10
호텔M스토리,10,10,127.0342247,37.26229292,20
호텔가덴,12,12,127.0213532,37.25706029,24
호텔국도,17,16,126.9962874,37.56619538,33
호텔그라모스,4,4,127.0398722,37.50255462,8
호텔그레이스리 서울,59,60,126.9769107,37.56161792,119
호텔그레이스리 서울 조식식당,2,2,126.9768612,37.5616151,4
호텔그림,9,9,126.9895653,37.57224426,18
호텔달,15,15,127.0169831,37.28682658,30
호텔더디자이너스 DDP점,10,10,127.0040878,37.56376649,20
호텔더디자이너스 동대문,19,19,127.0056502,37.56363827,38
호텔더디자이너스 서울역점,4,4,126.9715803,37.54554295,8
호텔더디자이너스 인천점,8,9,126.7070949,37.45102464,17
호텔더디자이너스 종로점,6,6,126.9890609,37.56936373,12
호텔더메이,19,18,127.0167042,37.58693448,37
호텔더스타일,3,3,127.0308317,37.26568087,6
호텔더캐슬 2호점,4,5,127.1091357,37.51535205,9
호텔더헤이리,7,7,126.6838769,37.79799305,14
호텔도노,37,37,127.0138338,37.28704126,74
호텔디아티스트 성신여대점,4,4,127.0187523,37.59390041,8
호텔디엠,3,3,127.0193935,37.57333333,6
호텔라엘르,10,10,126.8306006,37.65701784,20
호텔라와,3,3,126.9891782,37.57227666,6
호텔로와,5,5,127.0330883,37.25962255,10
호텔로젠하임,8,8,126.7884841,37.64169802,16
호텔로프트,1,1,126.8987267,37.53462878,2
호텔루시,4,4,127.2131793,37.54010653,8
호텔르오,5,5,126.9083306,37.51768428,10
호텔리베라 청담,24,23,127.0542641,37.52388466,47
호텔릿,6,5,126.9738176,37.55466788,11
호텔마리,3,3,127.0421042,37.5016222,6
호텔마에스트로,4,4,127.2585856,37.10458188,8
호텔모모,2,2,126.9395194,37.55642936,4
호텔베뉴지,7,7,126.9907453,37.56861154,14
호텔베이204,4,4,126.7024794,37.44415372,8
호텔봄날,4,4,126.6379654,37.46280029,8
호텔부티크나인,8,9,127.0268126,37.57638985,17
호텔부티크나인 능동점,10,10,127.0801052,37.55645732,20
호텔세느장,9,9,126.9898256,37.57282452,18
호텔세븐스텝 시흥정왕점,3,3,126.7227539,37.35150529,6
호텔스위티안,17,17,127.4881997,37.69465025,34
호텔스카이파크 동대문1호점,42,42,127.0021415,37.56422223,84
호텔스카이파크 명동3호점,5,5,126.9872636,37.56130234,10
호텔스카이파크 센트럴명동점,4,3,126.9852608,37.56458173,7
호텔스퀘어 안산,9,8,126.7989979,37.31442343,17
호텔식스티,1,1,127.082319,37.51128683,2
호텔신북온천,7,7,127.1022752,37.97280146,14
호텔써클 합정점,5,5,126.9107367,37.54887156,10
호텔썬샤인,2,2,126.7431531,37.39064494,4
호텔썬스테이,10,10,127.1998306,37.23318322,20
호텔썬플라워,2,2,127.1169655,35.83478565,4
호텔아띠,18,23,126.6216093,37.47428012,41
호텔아르떼,25,21,127.0290416,37.26613635,46
호텔아마레,2,3,126.9707045,37.28135667,5
호텔아망,2,1,126.8383158,37.6623012,3
호텔아벤트리 종로,12,12,126.9833369,37.57310489,24
호텔아이린시티,5,5,126.9779926,37.56207583,10
호텔아트리움 종로,18,18,126.9981254,37.57188431,36
호텔애비뉴186,2,2,126.9615314,37.39409102,4
호텔앤드,5,5,126.9708208,37.28111251,10
호텔야자 강서구청점,3,2,126.8463955,37.5471908,5
호텔야자 곤지암점,4,4,127.351747,37.34333856,8
호텔야자 구리수택점,3,3,127.1380771,37.59773414,6
호텔야자 동인천역점,3,3,126.6306834,37.4739232,6
호텔야자 모란역점,5,5,127.1323596,37.43306615,10
호텔야자 종로점,5,5,126.98892,37.57308393,10
호텔어반,7,7,127.1098967,37.51592438,14
호텔엘리스,1,1,127.4170141,37.49988634,2
호텔오라,12,12,126.6241601,37.47952049,24
호텔오로이,4,3,126.8319197,37.31081297,7
호텔월,8,7,126.7354918,37.40139884,15
호텔월미여관,5,5,126.5994468,37.47367367,10
호텔이쁘다,10,10,127.0926797,37.82128398,20
호텔인나인,13,13,127.0600359,37.51558273,26
호텔인트라다 이천,3,3,127.4911964,37.2523615,6
호텔자라,3,4,127.5149244,37.82253469,7
호텔카푸치노,12,11,127.0315085,37.50683152,23
호텔컬리넌 건대점,1,1,127.0690493,37.55055736,2
호텔컬리넌 종로,8,8,126.9893956,37.57196674,16
호텔케이월드,2,5,127.0634253,37.54058213,7
호텔코너인,5,5,127.0549186,37.07479327,10
호텔코지,2,3,127.7259178,37.88153363,5
호텔쿠레타케소 인사동,8,8,126.9871723,37.57239539,16
호텔큐브,5,5,128.9131969,37.79982576,10
호텔클로버,5,5,126.8500316,37.30860995,10
호텔토마스 명동,4,4,126.9783771,37.56314268,8
호텔투헤븐,1,1,126.9896944,37.57224427,2
호텔파크하비오,4,4,127.1235091,37.48182408,8
호텔팝리즈프리미어,3,3,126.9901654,37.57110185,6
호텔포코,10,10,127.0570438,37.54344588,20
호텔푸르미르,14,16,126.9847805,37.20893692,30
호텔피아노,2,1,127.0217912,37.5814797,3
호퍼앤호크니,5,5,127.0119761,37.28619286,10
호호떡볶기,2,2,126.9544468,37.3893239,4
호호식당 대학로점,5,5,127.0000091,37.58190338,10
호호식당 도산공원,5,5,127.036642,37.5250231,10
호화반점,4,4,127.0398038,37.52694662,8
홀리데이인익스프레스서울홍대,5,5,126.926734,37.55756008,10
홀리데이인인천송도,12,12,126.6330159,37.39309172,24
홀인원쌈밥집,3,3,127.6881403,37.32948918,6
홈마트,4,4,127.48748,37.67320744,8
홈마트 내동점,4,4,126.7889486,37.52139839,8
홈마트 송추점,3,3,126.9745028,37.7188933,6
홈보이서울,5,5,126.9731569,37.57621325,10
홈플러스 강동점,7,7,127.1422288,37.54555803,14
홈플러스 동수원점,3,3,127.0304247,37.26288504,6
홈플러스 면목점,4,3,127.081974,37.58052703,7
홈플러스 방학점,7,8,127.0436673,37.66484739,15
홈플러스 병점점,5,5,127.0368128,37.20379618,10
홈플러스 부천소사점,5,5,126.8143443,37.48490711,10
홈플러스 분당오리점,5,5,127.106996,37.34097124,10
홈플러스 서수원점,9,8,126.72446,35.39083487,17
홈플러스 서울상봉점,5,5,127.08982,37.59780415,10
홈플러스 스페셜 가양점,2,2,126.8500389,37.56431622,4
홈플러스 스페셜 시화점,4,4,126.7250804,37.34522335,8
홈플러스 영등포점,5,3,126.8958915,37.5182398,8
홈플러스 영통점,5,5,127.0728158,37.25208648,10
홈플러스 오산점,10,9,127.0621305,37.17010602,19
홈플러스 월드컵점,3,3,126.8985906,37.56832328,6
홈플러스 의정부점,8,8,127.071045,37.75213666,16
홈플러스 인천청라점,4,4,126.6486334,37.53231597,8
홈플러스 일산점,13,13,126.768888,37.65894929,26
홈플러스 진접점,4,4,127.188609,37.72174723,8
홈플러스 파주문산점,7,7,126.7849816,37.86959989,14
홈플러스 포천송우점,4,4,127.141324,37.82427819,8
홈플러스 합정점,2,2,126.9133027,37.55127012,4
홈플러스익스프레스 고양중산점,5,5,126.7871832,37.67511124,10
홈플러스익스프레스 수원연무점,5,5,127.0311314,37.2926372,10
홈플러스익스프레스 인천경서점,3,4,126.6531952,37.5587791,7
홍가네우렁쌈밥,5,5,127.1487444,37.77728222,10
홍건익가옥,2,4,126.9688635,37.57791328,6
홍길동생선구이,3,3,126.7493836,37.67049605,6
홍남매손칼국수,3,4,127.0228271,37.29494215,7
홍대 ak위드뮤m,5,5,126.9262356,37.5580134,10
홍대개미 신세계백화점 본점,5,5,126.980981,37.56091947,10
홍대네컷 뚝섬유원지점,4,4,127.0681493,37.53400833,8
홍대네컷 홍대2호점,4,4,126.9218335,37.55325828,8
홍대돈부리 롯데월드몰점,5,5,127.1040885,37.51364109,10
홍대동물원,5,5,126.922985,37.55375458,10
홍대문화예술관광특구,5,5,126.9237664,37.5555188,10
홍대앞걷고싶은거리,32,32,126.9242639,37.55594123,64
홍대예술의거리,11,10,126.9214115,37.55204345,21
홍대입구역 2호선,36,31,126.9237786,37.55687074,67
홍대입구역 2호선 9번출구,5,5,126.9229962,37.55604312,10
홍대입구역 공항철도,5,5,126.9270104,37.55730527,10
홍대조폭떡볶이,4,3,126.9213815,37.55040001,7
홍대축제거리,9,9,126.9213489,37.55123431,18
홍대클럽거리,2,2,126.9230652,37.55058132,4
홍대패션거리,47,46,126.9235809,37.55539659,93
홍두깨손칼국수,4,4,126.7850717,37.85619574,8
홍두깨칼국수,5,5,126.8566508,37.4805673,10
홍라드,9,9,127.0164411,37.28350002,18
홍미닭발 신사본점,3,4,127.0203042,37.51705316,7
홍삼스파참숯가마사우나,2,2,126.7173491,37.77384049,4
홍성군 서부면 남당항로 210-1,4,4,126.5200182,33.25455663,8
홍수계찜닭 트리플스트리트점,5,5,126.6613356,37.37988709,10
홍스쭈꾸미 홍대본점,3,3,126.9260971,37.55618746,6
홍시,5,5,127.6485806,37.6356773,10
홍싸이클,4,4,126.7503903,37.48696524,8
홍예문,3,4,126.6263204,37.47468074,7
홍원막국수 본관,5,5,127.5473332,37.40255788,10
홍이부대찌개,4,4,127.0496162,37.7443002,8
홍익대학교,5,5,126.9255546,37.55087484,10
홍익대학교 대학로캠퍼스 주차장,3,3,127.0011739,37.57655687,6
홍익대학교 서울캠퍼스,13,12,126.9255546,37.55087484,25
홍익돈까스 기흥점,5,5,127.1469339,37.27492218,10
홍익돈까스 남양주진접점,4,4,127.1950994,37.73391688,8
홍익돈까스 천천점,5,5,126.9810375,37.30122125,10
홍익스포츠스파,10,10,127.0053349,37.26732196,20
홍익약국,3,4,126.9246115,37.55686047,7
홍재교,3,4,127.0562636,37.29359023,7
홍제동30년 우동국수,4,4,126.9078109,37.61632487,8
홍제천,4,5,126.9526224,37.59632056,9
홍종흔베이커리 미사한강점,5,5,127.202094,37.57152754,10
홍천냉면,3,3,127.1347246,37.20113207,6
홍천휴게소 양양방향,5,5,128.0032377,37.75729303,10
홍콩반점0410 동대문점,2,2,127.0080661,37.56780884,4
홍콩포차,4,4,127.0704133,37.54722647,8
홍희쌀케이크,5,5,127.0834465,37.50808927,10
화곡본동시장,5,5,126.8435339,37.54325509,10
화곡역 5호선,11,11,126.840455,37.54165079,22
화끈곱창,3,4,127.1243456,37.38608488,7
화담숲,311,311,127.27373,37.22673177,622
화담숲 번지없는 주막,4,4,126.8028655,37.55894903,8
화담숲 소나무정원,5,5,127.302371,37.3373679,10
화담숲가을단풍축제,5,5,127.2892434,37.34169682,10
화덕고깃간 역삼점,4,4,127.0331674,37.50117635,8
화덕에구운족발신선생 영등포점,4,4,126.9093933,37.51812659,8
화동옥 종로북촌점,3,4,126.9869945,37.57945556,7
화떡,4,4,126.9837919,37.56299398,8
화랑공원,5,6,127.1055947,37.39756412,11
화랑대철도공원,14,14,127.0928038,37.62429903,28
화랑유원지,8,8,126.8143419,37.32659442,16
"화랑유원지, 김홍도 축제",5,5,126.5092014,33.2483545,10
화목순대국,7,8,126.9315066,37.51926954,15
화목순대국 광화문1호점,5,5,126.974714,37.57119686,10
화목칼국수,8,8,126.6863411,37.79012076,16
화미연안주차장,5,5,126.6152796,37.45222827,10
화사한 인천점,4,4,126.7026839,37.44388844,8
화산채,4,4,127.3119381,37.33358397,8
화서공원,36,36,127.0078486,37.28470829,72
화서시장,4,4,127.0020747,37.27856705,8
화서주공3단지아파트,4,5,126.9922054,37.28591929,9
화서휴게소주유소 상주방향,3,3,127.9248562,36.44436182,6
화성게스트하우스,6,6,127.0159577,37.27957516,12
화성관광열차안내소 연무대매표소,26,26,127.0233392,37.28787791,52
화성상록GC,10,10,127.1333726,37.19712392,20
화성시가족센터,4,5,127.0332257,37.20293584,9
화성시역사박물관,4,5,126.9280416,37.13259838,9
화성시우리꽃식물원,8,7,126.8814669,37.11587868,15
화성융릉과건릉,34,33,126.9909693,37.2117236,67
화성종합경기타운,4,4,126.924593,37.13752144,8
화성행궁,457,486,127.0140412,37.2819145,943
화성행궁 관람,1,3,127.7503169,34.74350696,4
"화성행궁 앞,옆 광장,행궁로",3,5,126.7528584,33.38870699,8
화성행궁 주차장,3,3,127.0139868,37.28073595,6
화성행궁광장,37,37,127.026047,37.27958006,74
화악산,11,11,127.5033279,37.9947832,22
화양연화,2,2,126.9650779,37.52425777,4
화양제일시장,3,3,127.0690807,37.54283038,6
화이트스노우,5,4,127.0440744,37.27806509,9
화이트아일랜드펜션,4,3,126.5566068,37.27400641,7
화이트큐브 24펜션,4,4,127.5019138,37.69907679,8
화이트헤이븐커피,4,4,127.1810808,37.57000112,8
화재매장,3,4,126.8469884,37.66441746,7
화적연,5,5,127.2627056,38.11505297,10
화정역광장,7,8,126.8325399,37.63418249,15
화정천,5,5,126.8204165,37.30575749,10
화청갈비,4,4,127.0202186,37.28311469,8
화춘옥 청담점,3,4,127.0377104,37.52148363,7
화포식당 노원점,4,4,127.0630092,37.65604507,8
화홍문공영주차장,14,13,127.0162575,37.28960909,27
화홍문화예술센터,5,5,127.015403,37.27996628,10
화홍사랑채,8,8,127.0172177,37.28703198,16
화홍통닭,3,4,127.0174383,37.28510733,7
확붕이네,4,4,127.7468576,37.43376669,8
환구단,16,16,126.9797394,37.56494131,32
환식당,4,4,126.9975398,37.58390176,8
환타콜라리조트,4,4,127.4944026,37.82418486,8
활명수 1897,4,5,127.0431353,37.54634759,9
황금뜰한정식,1,1,127.4187477,37.2457928,2
황금민물장어,5,5,126.7513663,37.67280765,10
황금손가락초밥,4,4,127.0916637,37.53521417,8
황금손칼국수&간장게장,4,4,126.5718839,37.27051798,8
황금시래기밥 도둑코다리,4,4,127.3435034,37.58802405,8
황금어장,2,4,126.7370469,37.39852265,6
황남비빔밥,5,5,129.2102603,35.83405779,10
황남샌드,4,2,129.2097779,35.83693019,6
황도면옥,4,3,126.9876309,37.20729013,7
황룡강주유소,4,4,126.7732131,35.29184588,8
황룡산,5,5,126.7758476,37.71243924,10
황리단길,12,11,129.2096454,35.83933482,23
황리단길 청온채,2,3,129.209724,35.8376609,5
황새울 공원,5,5,127.1182222,37.3840044,10
황생가칼국수,31,33,126.980641,37.58006016,64
황소가한우곱창&전골,5,5,127.1104586,37.34891874,10
황순옥옛날감자탕 본점,4,4,127.2220371,37.28153409,8
황순원문학관 소나기마을,11,11,127.3782723,37.59619962,22
황재벌,4,4,127.0314648,37.48612279,8
황제능이버섯백숙,4,5,127.6485962,37.3185868,9
황태속이야기,5,5,127.6041817,37.49844664,10
황토민물장어,2,2,127.1877083,37.52349208,4
황평집,4,4,126.996129,37.56406722,8
황포돛배,4,4,126.8896798,37.96500111,8
황학산,3,4,127.6475026,37.271436,7
황학정 국궁전시관,3,3,126.9647657,37.57706159,6
황해,5,5,127.1071668,36.8126286,10
황해수육 부천상동점,5,5,126.7590064,37.49220445,10
황희선생유적지,8,7,126.7531685,37.8674545,15
회기역 1호선,4,4,127.0580484,37.58979622,8
회기왕족발보쌈,4,4,127.0535111,37.59085433,8
회뜨는달인,5,5,127.1501753,37.83259026,10
회뜨는수산,4,4,126.7145458,37.36087625,8
회뜨는총각,3,3,126.9251533,37.56287587,6
회룡문화공원,4,4,127.045004,37.72360496,8
회룡사,5,5,127.0276412,37.72000822,10
회룡역 1호선,8,9,127.0472954,37.72380588,17
회산막국수,4,4,127.9197895,37.3596642,8
회암사지,4,4,127.10585,37.84577344,8
회암사지박물관,8,8,127.1029474,37.84110817,16
회현지하쇼핑센터,3,3,126.98171,37.56040422,6
횡성역,8,8,128.010038,37.48309966,16
횡성휴게소 강릉방향,7,7,128.1339886,37.46286726,14
횡성휴게소 인천방향,3,3,128.1353932,37.46516024,6
효담곤드레산채밥상,4,4,127.1647782,37.78003225,8
효뜨,8,8,126.9713089,37.53035022,16
효사정,4,4,126.9627476,37.51054198,8
효원공원,14,15,127.0382717,37.26425595,29
효원공원 월화원,120,126,127.0377333,37.26524908,246
효자로 가을단풍길,5,5,128.8814995,37.7541665,10
효자바베,5,5,126.9701047,37.57675312,10
효자베이커리,4,4,126.9686675,37.58094056,8
효자촌 먹자골목(강남면옥),4,4,126.8988844,37.48317255,8
효정명인갈비,4,4,127.4993589,37.67655351,8
효창공원,4,4,126.9610375,37.54508224,8
후디커피,5,5,127.3797485,37.6807176,10
후라토식당 동탄레이크꼬모점,4,4,127.1058962,37.17219067,8
후라토식당 본점,3,4,126.9742926,37.57202208,7
후라토식당 분당정자점,5,5,127.1063081,37.3652861,10
후라토식당 송도트리플스트리트점,4,4,126.659384,37.38075457,8
후라토식당 여의도직영점,9,9,126.924138,37.52386015,18
후레쉬베리 구리점,4,5,127.1394013,37.59859032,9
후소이살몬,4,4,127.0128894,37.28560889,8
후암동 일대,3,5,126.9814212,37.5498915,8
후암편백 현대백화점 중동점,3,3,126.7620741,37.50435171,6
후와후와 광화문점,8,8,126.9789046,37.57105352,16
후추포인트,4,4,127.0272557,37.50307718,8
후쿠오카함바그 롯데월드몰점,3,3,127.1041881,37.51369507,6
후타츠,5,5,127.0341191,37.64635788,10
후탄펜션,1,1,127.3978013,37.75937197,2
후후케이크,4,5,126.874531,37.46452714,9
훈장골 사당점,3,3,126.9811062,37.47714782,6
훈춘양꼬치,5,5,127.0688798,37.53844803,10
훕훕베이글,3,4,126.8669759,37.48672605,7
훠궈나라 대학로본점,9,9,126.9991849,37.58293411,18
훠궈야 스타필드 고양점,5,5,126.8947784,37.64697631,10
훠궈야 여의도IFC몰점,4,4,126.9248697,37.5251923,8
훼릭스 숲속에서그릴,5,5,126.8614956,37.64741044,10
훼미리사우나파크,4,3,126.9631434,37.39321754,7
휘경센트레빌아파트 104동,4,3,127.0685971,37.59049153,7
휘경해모로프레스티지아파트,5,5,127.0621494,37.59122671,10
휘피디저트카페,4,4,126.7251034,37.4934441,8
휴먼시아7단지아파트,6,6,126.8918454,37.44446699,12
휴먼시아푸르내마을13단지아파트,3,3,126.7350698,37.40705539,6
휴모텔,4,4,127.7166986,37.88451274,8
휴유,4,4,127.1172255,37.34357183,8
휴이파스타,5,5,127.011287,37.28585053,10
휴카페,4,3,126.921846,37.5520978,7
흐꺙,4,4,126.9716297,37.57937719,8
흐이,5,5,126.980093,37.54628712,10
흑백사장 더 필름,4,3,127.052651,37.5433434,7
흑사당,3,4,126.6976525,37.78749611,7
흑석시장,5,5,126.9628941,37.50690557,10
흑석한강푸르지오아파트,5,5,126.9654429,37.50321223,10
흑유재,3,5,127.5309926,37.46777872,8
흔들바위,2,2,127.4513031,37.07627215,4
흠커피,5,5,127.1851491,37.52012277,10
흥구석유 산격주유소,3,3,128.5979484,35.90225424,6
흥국생명 본사금융플라자,4,3,127.0421479,36.00442079,7
흥도식당,5,5,127.2045814,37.55886428,10
흥륜사,4,4,126.6595375,37.41621545,8
흥륜사쉼터,4,4,126.6593723,37.41678442,8
흥부네돈잔치,4,4,127.0285845,37.91030561,8
흥숙이김치찜,2,2,127.0347277,37.26276943,4
흥인지문,34,36,127.0095719,37.57114151,70
흥인지문.광장시장,4,4,127.0095719,37.57114151,8
흥인지문공원,13,14,127.0092143,37.57193442,27
희락갈치,9,9,126.9770969,37.5598484,18
희락보리,11,10,127.2287944,37.27616726,21
희래객,7,7,126.6194195,37.47561738,14
희릿,4,5,127.0484412,37.54266045,9
희정식당,5,5,126.9309052,37.52623394,10
히노아지,5,5,126.6609544,37.37979229,10
히든코인싱어 홍대점,3,3,126.9254453,37.55604289,6
히든플랜트,5,5,127.3776481,37.67963958,10
히바린 스타필드안성점,5,5,127.1467827,36.994831,10
히어로보드게임카페 홍대2호점,5,5,126.9227027,37.55534916,10
히어로키즈파크 동탄지점,5,5,127.0902327,37.20170954,10
히얼유아스토어,3,3,127.0134738,37.28711176,6
히츠지야 영등포역점,5,5,126.9069033,37.51748764,10
히츠지야 한국본점,4,4,126.9168131,37.54932649,8
힐링닭갈비,12,12,127.5237341,37.80911496,24
힐링빌,13,13,127.2887176,37.33994651,26
힐링숲펜션,6,6,127.0500927,37.35533538,12
힐링카라반펜션,5,5,126.890349,37.99246937,10
힐링텐트,4,4,127.0034065,37.50610045,8
힐사이드모텔,1,1,127.2241708,37.5786704,2
힐사이드테이블,5,5,126.9709665,37.57287545,10
힐스테이트범계역모비우스오피스텔,4,4,126.9515911,37.39082927,8
힐튼가든인 서울강남점,37,37,127.0327876,37.48593322,74
힐하우스,5,5,127.1614476,37.7706236,10
힘찬갯벌낙지,5,5,126.4909019,33.4855377,10
힘찬장어,8,9,127.2287939,37.56672157,17
